"","Date","DirRigCount","HorzRigCount","VertRigCount","TotalRigCount","PerDirRig","PercHorzRig","PercVertRig"
"1","1991-01-04",81,100,927,1108,0.0731046931407942,0.0902527075812274,0.836642599277978
"2","1991-01-11",93,102,853,1048,0.0887404580152672,0.0973282442748092,0.813931297709924
"3","1991-01-18",100,102,863,1065,0.0938967136150235,0.0957746478873239,0.810328638497653
"4","1991-01-25",111,104,836,1051,0.105613701236917,0.09895337773549,0.795432921027593
"5","1991-02-01",122,106,768,996,0.122489959839357,0.106425702811245,0.771084337349398
"6","1991-02-08",123,99,775,997,0.123370110330993,0.0992978936810431,0.777331995987964
"7","1991-02-15",122,95,760,977,0.124872057318321,0.0972364380757421,0.777891504605937
"8","1991-02-22",128,99,740,967,0.132368148914168,0.102378490175801,0.765253360910031
"9","1991-03-01",121,95,733,949,0.127502634351949,0.100105374077977,0.772391991570074
"10","1991-03-08",124,89,735,948,0.130801687763713,0.0938818565400844,0.775316455696203
"11","1991-03-15",124,86,698,908,0.136563876651982,0.0947136563876652,0.768722466960352
"12","1991-03-22",115,87,709,911,0.126234906695939,0.0954994511525796,0.778265642151482
"13","1991-03-29",124,85,701,910,0.136263736263736,0.0934065934065934,0.77032967032967
"14","1991-04-05",124,79,678,881,0.140749148694665,0.0896708286038593,0.769580022701476
"15","1991-04-12",125,70,679,874,0.143020594965675,0.080091533180778,0.776887871853547
"16","1991-04-19",122,69,644,835,0.146107784431138,0.0826347305389222,0.77125748502994
"17","1991-04-26",123,68,633,824,0.149271844660194,0.0825242718446602,0.768203883495146
"18","1991-05-03",124,59,622,805,0.154037267080745,0.0732919254658385,0.772670807453416
"19","1991-05-10",130,60,612,802,0.162094763092269,0.0748129675810474,0.763092269326683
"20","1991-05-17",130,57,631,818,0.158924205378973,0.0696821515892421,0.771393643031785
"21","1991-05-24",120,66,660,846,0.141843971631206,0.0780141843971631,0.780141843971631
"22","1991-05-31",125,61,638,824,0.151699029126214,0.0740291262135922,0.774271844660194
"23","1991-06-07",121,73,656,850,0.142352941176471,0.0858823529411765,0.771764705882353
"24","1991-06-14",118,77,676,871,0.135476463834673,0.0884041331802526,0.776119402985075
"25","1991-06-21",112,75,679,866,0.12933025404157,0.0866050808314088,0.784064665127021
"26","1991-06-28",110,76,695,881,0.124858115777526,0.0862656072644722,0.788876276958002
"27","1991-07-05",106,73,680,859,0.123399301513388,0.0849825378346915,0.791618160651921
"28","1991-07-12",106,69,669,844,0.125592417061611,0.0817535545023697,0.792654028436019
"29","1991-07-19",105,65,658,828,0.126811594202899,0.0785024154589372,0.794685990338164
"30","1991-07-26",105,74,666,845,0.124260355029586,0.0875739644970414,0.788165680473373
"31","1991-08-02",109,71,651,831,0.131167268351384,0.085439229843562,0.783393501805054
"32","1991-08-09",105,63,628,796,0.131909547738693,0.0791457286432161,0.788944723618091
"33","1991-08-16",107,62,628,797,0.134253450439147,0.0777917189460477,0.787954830614806
"34","1991-08-23",105,61,626,792,0.132575757575758,0.077020202020202,0.79040404040404
"35","1991-08-30",106,65,628,799,0.132665832290363,0.081351689612015,0.785982478097622
"36","1991-09-06",101,65,632,798,0.1265664160401,0.081453634085213,0.791979949874687
"37","1991-09-13",101,69,588,758,0.133245382585752,0.0910290237467019,0.775725593667546
"38","1991-09-20",95,71,604,770,0.123376623376623,0.0922077922077922,0.784415584415584
"39","1991-09-27",92,72,611,775,0.118709677419355,0.0929032258064516,0.788387096774194
"40","1991-10-04",91,72,623,786,0.115776081424936,0.0916030534351145,0.792620865139949
"41","1991-10-11",86,74,636,796,0.108040201005025,0.092964824120603,0.798994974874372
"42","1991-10-18",90,71,636,797,0.112923462986198,0.0890840652446675,0.797992471769134
"43","1991-10-25",93,67,641,801,0.116104868913858,0.083645443196005,0.800249687890137
"44","1991-11-01",93,70,630,793,0.117276166456494,0.0882723833543506,0.794451450189155
"45","1991-11-08",93,64,639,796,0.116834170854271,0.0804020100502513,0.802763819095477
"46","1991-11-15",87,60,656,803,0.108343711083437,0.074719800747198,0.816936488169365
"47","1991-11-22",89,67,672,828,0.107487922705314,0.0809178743961353,0.811594202898551
"48","1991-11-29",94,65,663,822,0.114355231143552,0.0790754257907543,0.806569343065694
"49","1991-12-06",86,65,663,814,0.105651105651106,0.0798525798525799,0.814496314496315
"50","1991-12-13",91,64,647,802,0.113466334164589,0.0798004987531172,0.806733167082294
"51","1991-12-20",92,66,639,797,0.11543287327478,0.082810539523212,0.801756587202008
"52","1991-12-27",86,61,623,770,0.111688311688312,0.0792207792207792,0.809090909090909
"53","1992-01-03",88,62,614,764,0.115183246073298,0.081151832460733,0.803664921465969
"54","1992-01-10",95,61,576,732,0.129781420765027,0.0833333333333333,0.786885245901639
"55","1992-01-17",91,61,564,716,0.127094972067039,0.085195530726257,0.787709497206704
"56","1992-01-24",92,59,535,686,0.134110787172012,0.0860058309037901,0.779883381924198
"57","1992-01-31",94,54,505,653,0.143950995405819,0.0826952526799388,0.773353751914242
"58","1992-02-07",95,61,518,674,0.140949554896142,0.0905044510385757,0.768545994065282
"59","1992-02-14",95,54,512,661,0.143721633888048,0.0816944024205749,0.774583963691377
"60","1992-02-21",94,50,523,667,0.140929535232384,0.0749625187406297,0.784107946026987
"61","1992-02-28",99,51,523,673,0.147102526002972,0.0757800891530461,0.777117384843982
"62","1992-03-06",99,50,511,660,0.15,0.0757575757575758,0.774242424242424
"63","1992-03-13",102,53,494,649,0.157164869029276,0.0816640986132511,0.761171032357473
"64","1992-03-20",100,50,493,643,0.15552099533437,0.0777604976671851,0.766718506998445
"65","1992-03-27",99,51,489,639,0.154929577464789,0.07981220657277,0.765258215962441
"66","1992-04-03",103,56,499,658,0.156534954407295,0.0851063829787234,0.758358662613982
"67","1992-04-10",99,55,494,648,0.152777777777778,0.0848765432098765,0.762345679012346
"68","1992-04-17",101,57,481,639,0.158059467918623,0.0892018779342723,0.752738654147105
"69","1992-04-24",93,60,470,623,0.149277688603531,0.0963081861958267,0.754414125200642
"70","1992-05-01",89,59,486,634,0.140378548895899,0.0930599369085174,0.766561514195584
"71","1992-05-08",87,58,490,635,0.137007874015748,0.0913385826771654,0.771653543307087
"72","1992-05-15",92,56,504,652,0.141104294478528,0.0858895705521472,0.773006134969325
"73","1992-05-22",88,64,486,638,0.137931034482759,0.100313479623824,0.761755485893417
"74","1992-05-29",82,62,485,629,0.130365659777424,0.0985691573926868,0.771065182829889
"75","1992-06-05",81,58,471,610,0.132786885245902,0.0950819672131148,0.772131147540984
"76","1992-06-12",81,56,459,596,0.135906040268456,0.0939597315436242,0.77013422818792
"77","1992-06-19",76,61,495,632,0.120253164556962,0.0965189873417722,0.783227848101266
"78","1992-06-26",81,58,506,645,0.125581395348837,0.089922480620155,0.784496124031008
"79","1992-07-03",84,55,509,648,0.12962962962963,0.0848765432098765,0.785493827160494
"80","1992-07-10",82,57,528,667,0.122938530734633,0.0854572713643178,0.79160419790105
"81","1992-07-17",81,56,552,689,0.117561683599419,0.081277213352685,0.801161103047895
"82","1992-07-24",78,56,554,688,0.113372093023256,0.0813953488372093,0.805232558139535
"83","1992-07-31",75,60,555,690,0.108695652173913,0.0869565217391304,0.804347826086957
"84","1992-08-07",81,58,570,709,0.114245416078985,0.0818053596614951,0.803949224259521
"85","1992-08-14",78,59,541,678,0.115044247787611,0.0870206489675516,0.797935103244838
"86","1992-08-21",76,56,557,689,0.110304789550073,0.081277213352685,0.808417997097242
"87","1992-08-28",67,52,549,668,0.100299401197605,0.0778443113772455,0.82185628742515
"88","1992-09-04",66,53,587,706,0.0934844192634561,0.075070821529745,0.831444759206799
"89","1992-09-11",66,50,571,687,0.0960698689956332,0.0727802037845706,0.831149927219796
"90","1992-09-18",64,48,608,720,0.0888888888888889,0.0666666666666667,0.844444444444445
"91","1992-09-25",67,47,641,755,0.0887417218543046,0.0622516556291391,0.849006622516556
"92","1992-10-02",67,51,638,756,0.0886243386243386,0.0674603174603175,0.843915343915344
"93","1992-10-09",76,51,660,787,0.096569250317662,0.0648030495552732,0.838627700127065
"94","1992-10-16",71,49,683,803,0.0884184308841843,0.0610211706102117,0.850560398505604
"95","1992-10-23",77,47,706,830,0.0927710843373494,0.0566265060240964,0.850602409638554
"96","1992-10-30",79,44,715,838,0.094272076372315,0.0525059665871122,0.853221957040573
"97","1992-11-06",76,44,733,853,0.0890973036342321,0.0515826494724502,0.859320046893318
"98","1992-11-13",80,45,760,885,0.0903954802259887,0.0508474576271186,0.858757062146893
"99","1992-11-20",83,46,761,890,0.0932584269662921,0.051685393258427,0.855056179775281
"100","1992-11-27",86,48,765,899,0.0956618464961068,0.053392658509455,0.850945494994438
"101","1992-12-04",87,45,782,914,0.0951859956236324,0.0492341356673961,0.855579868708972
"102","1992-12-11",89,53,788,930,0.0956989247311828,0.056989247311828,0.847311827956989
"103","1992-12-18",92,53,790,935,0.0983957219251337,0.0566844919786096,0.844919786096257
"104","1992-12-23",88,50,790,928,0.0948275862068965,0.0538793103448276,0.851293103448276
"105","1992-12-30",85,48,789,922,0.0921908893709328,0.052060737527115,0.855748373101952
"106","1993-01-08",89,48,766,903,0.0985603543743079,0.053156146179402,0.84828349944629
"107","1993-01-15",85,44,709,838,0.101431980906921,0.0525059665871122,0.846062052505967
"108","1993-01-22",92,46,656,794,0.115869017632242,0.0579345088161209,0.826196473551637
"109","1993-01-29",92,47,623,762,0.120734908136483,0.0616797900262467,0.81758530183727
"110","1993-02-05",91,47,582,720,0.126388888888889,0.0652777777777778,0.808333333333333
"111","1993-02-12",86,44,568,698,0.123209169054441,0.0630372492836676,0.813753581661891
"112","1993-02-19",85,42,529,656,0.129573170731707,0.0640243902439024,0.80640243902439
"113","1993-02-26",88,44,531,663,0.132730015082956,0.0663650075414781,0.800904977375566
"114","1993-03-05",80,45,495,620,0.129032258064516,0.0725806451612903,0.798387096774194
"115","1993-03-12",72,47,481,600,0.12,0.0783333333333333,0.801666666666667
"116","1993-03-19",74,43,497,614,0.120521172638436,0.0700325732899023,0.809446254071661
"117","1993-03-26",76,40,494,610,0.124590163934426,0.0655737704918033,0.809836065573771
"118","1993-03-31",80,43,504,627,0.127591706539075,0.0685805422647528,0.803827751196172
"119","1993-04-08",80,46,489,615,0.130081300813008,0.0747967479674797,0.795121951219512
"120","1993-04-16",80,44,479,603,0.132669983416252,0.0729684908789387,0.794361525704809
"121","1993-04-23",80,44,484,608,0.131578947368421,0.0723684210526316,0.796052631578947
"122","1993-04-30",79,48,482,609,0.129720853858785,0.0788177339901478,0.791461412151067
"123","1993-05-07",77,50,490,617,0.124797406807131,0.0810372771474878,0.794165316045381
"124","1993-05-14",83,48,488,619,0.134087237479806,0.0775444264943457,0.788368336025848
"125","1993-05-21",90,48,503,641,0.140405616224649,0.0748829953198128,0.784711388455538
"126","1993-05-28",99,47,525,671,0.147540983606557,0.0700447093889717,0.782414307004471
"127","1993-06-04",100,48,538,686,0.145772594752187,0.0699708454810496,0.784256559766764
"128","1993-06-11",108,46,557,711,0.151898734177215,0.0646976090014065,0.783403656821378
"129","1993-06-18",95,44,542,681,0.139500734214391,0.0646108663729809,0.795888399412628
"130","1993-06-25",92,52,558,702,0.131054131054131,0.0740740740740741,0.794871794871795
"131","1993-07-02",93,61,578,732,0.127049180327869,0.0833333333333333,0.789617486338798
"132","1993-07-09",85,58,570,713,0.119214586255259,0.0813464235624123,0.799438990182328
"133","1993-07-16",86,59,575,720,0.119444444444444,0.0819444444444444,0.798611111111111
"134","1993-07-23",93,59,613,765,0.12156862745098,0.077124183006536,0.801307189542484
"135","1993-07-30",92,59,625,776,0.118556701030928,0.0760309278350516,0.805412371134021
"136","1993-08-06",99,57,620,776,0.127577319587629,0.0734536082474227,0.798969072164949
"137","1993-08-13",101,54,631,786,0.128498727735369,0.0687022900763359,0.802798982188295
"138","1993-08-20",104,61,640,805,0.129192546583851,0.0757763975155279,0.795031055900621
"139","1993-08-27",104,62,656,822,0.126520681265207,0.0754257907542579,0.798053527980535
"140","1993-09-03",100,62,672,834,0.119904076738609,0.0743405275779377,0.805755395683453
"141","1993-09-10",103,57,675,835,0.123353293413174,0.0682634730538922,0.808383233532934
"142","1993-09-17",115,52,689,856,0.134345794392523,0.0607476635514019,0.804906542056075
"143","1993-09-24",117,50,699,866,0.135103926096998,0.0577367205542725,0.80715935334873
"144","1993-10-01",116,37,703,856,0.135514018691589,0.0432242990654206,0.821261682242991
"145","1993-10-08",119,33,704,856,0.139018691588785,0.0385514018691589,0.822429906542056
"146","1993-10-15",118,54,688,860,0.137209302325581,0.0627906976744186,0.8
"147","1993-10-22",123,53,684,860,0.143023255813954,0.0616279069767442,0.795348837209302
"148","1993-10-29",116,53,701,870,0.133333333333333,0.0609195402298851,0.805747126436782
"149","1993-11-05",116,50,704,870,0.133333333333333,0.0574712643678161,0.809195402298851
"150","1993-11-12",119,48,705,872,0.136467889908257,0.055045871559633,0.80848623853211
"151","1993-11-19",118,54,685,857,0.137689614935823,0.0630105017502917,0.799299883313886
"152","1993-11-26",126,57,688,871,0.144661308840413,0.0654420206659013,0.789896670493686
"153","1993-12-03",131,59,686,876,0.149543378995434,0.067351598173516,0.78310502283105
"154","1993-12-10",133,57,678,868,0.153225806451613,0.065668202764977,0.78110599078341
"155","1993-12-17",124,59,700,883,0.140430351075878,0.0668176670441676,0.792751981879955
"156","1993-12-22",128,51,664,843,0.151838671411625,0.0604982206405694,0.787663107947805
"157","1993-12-29",129,48,637,814,0.158476658476658,0.058968058968059,0.782555282555283
"158","1994-01-07",140,46,621,807,0.173482032218092,0.057001239157373,0.769516728624535
"159","1994-01-14",128,45,619,792,0.161616161616162,0.0568181818181818,0.781565656565657
"160","1994-01-21",128,47,603,778,0.16452442159383,0.0604113110539846,0.775064267352185
"161","1994-01-28",128,41,609,778,0.16452442159383,0.0526992287917738,0.782776349614396
"162","1994-02-04",133,44,575,752,0.17686170212766,0.0585106382978723,0.764627659574468
"163","1994-02-11",136,45,583,764,0.178010471204188,0.0589005235602094,0.763089005235602
"164","1994-02-18",135,47,570,752,0.179521276595745,0.0625,0.757978723404255
"165","1994-02-25",137,48,562,747,0.183400267737617,0.0642570281124498,0.752342704149933
"166","1994-03-04",133,47,563,743,0.179004037685061,0.063257065948856,0.757738896366083
"167","1994-03-11",131,49,553,733,0.178717598908595,0.0668485675306958,0.754433833560709
"168","1994-03-18",138,53,552,743,0.185733512786003,0.0713324360699865,0.742934051144011
"169","1994-03-25",136,50,539,725,0.187586206896552,0.0689655172413793,0.743448275862069
"170","1994-03-31",132,50,550,732,0.180327868852459,0.0683060109289617,0.751366120218579
"171","1994-04-08",128,53,528,709,0.180535966149506,0.07475317348378,0.744710860366714
"172","1994-04-15",133,52,535,720,0.184722222222222,0.0722222222222222,0.743055555555556
"173","1994-04-22",138,50,544,732,0.188524590163934,0.0683060109289617,0.743169398907104
"174","1994-04-29",144,47,539,730,0.197260273972603,0.0643835616438356,0.738356164383562
"175","1994-05-06",136,48,535,719,0.189151599443672,0.066759388038943,0.744089012517385
"176","1994-05-13",135,44,543,722,0.186980609418283,0.0609418282548476,0.75207756232687
"177","1994-05-20",129,44,524,697,0.185078909612626,0.0631276901004304,0.751793400286944
"178","1994-05-27",131,41,555,727,0.18019257221458,0.0563961485557084,0.763411279229711
"179","1994-06-03",144,40,558,742,0.194070080862534,0.0539083557951483,0.752021563342318
"180","1994-06-10",140,38,574,752,0.186170212765957,0.050531914893617,0.763297872340426
"181","1994-06-17",147,36,586,769,0.191157347204161,0.046814044213264,0.762028608582575
"182","1994-06-24",146,38,577,761,0.191852825229961,0.049934296977661,0.758212877792378
"183","1994-07-01",145,36,585,766,0.189295039164491,0.0469973890339426,0.763707571801567
"184","1994-07-08",141,43,584,768,0.18359375,0.0559895833333333,0.760416666666667
"185","1994-07-15",136,42,595,773,0.175937904269082,0.0543337645536869,0.769728331177232
"186","1994-07-22",130,50,599,779,0.166880616174583,0.0641848523748395,0.768934531450578
"187","1994-07-29",126,51,594,771,0.163424124513619,0.066147859922179,0.770428015564202
"188","1994-08-05",128,50,593,771,0.166018158236057,0.0648508430609598,0.769130998702983
"189","1994-08-12",131,46,576,753,0.173970783532537,0.0610889774236388,0.764940239043825
"190","1994-08-19",138,48,586,772,0.178756476683938,0.0621761658031088,0.759067357512953
"191","1994-08-26",141,50,577,768,0.18359375,0.0651041666666667,0.751302083333333
"192","1994-09-02",146,53,585,784,0.186224489795918,0.0676020408163265,0.746173469387755
"193","1994-09-09",142,55,585,782,0.181585677749361,0.0703324808184143,0.748081841432225
"194","1994-09-16",141,57,606,804,0.175373134328358,0.0708955223880597,0.753731343283582
"195","1994-09-23",144,56,636,836,0.172248803827751,0.0669856459330144,0.760765550239235
"196","1994-09-30",135,57,646,838,0.16109785202864,0.0680190930787589,0.770883054892601
"197","1994-10-07",134,57,637,828,0.161835748792271,0.0688405797101449,0.769323671497585
"198","1994-10-14",136,57,635,828,0.164251207729469,0.0688405797101449,0.766908212560387
"199","1994-10-21",136,56,627,819,0.166056166056166,0.0683760683760684,0.765567765567766
"200","1994-10-28",142,55,616,813,0.174661746617466,0.0676506765067651,0.757687576875769
"201","1994-11-04",143,53,628,824,0.173543689320388,0.0643203883495146,0.762135922330097
"202","1994-11-11",143,55,635,833,0.171668667466987,0.0660264105642257,0.762304921968788
"203","1994-11-18",145,61,633,839,0.172824791418355,0.0727056019070322,0.754469606674613
"204","1994-11-25",144,63,635,842,0.171021377672209,0.0748218527315915,0.754156769596199
"205","1994-12-02",138,59,630,827,0.166868198307134,0.0713422007255139,0.761789600967352
"206","1994-12-09",144,62,635,841,0.171224732461356,0.0737217598097503,0.755053507728894
"207","1994-12-16",137,54,616,807,0.169764560099133,0.0669144981412639,0.763320941759604
"208","1994-12-23",139,54,620,813,0.170971709717097,0.0664206642066421,0.762607626076261
"209","1994-12-30",137,57,597,791,0.173198482932996,0.0720606826801517,0.754740834386852
"210","1995-01-05",135,57,574,766,0.176240208877285,0.0744125326370757,0.74934725848564
"211","1995-01-13",127,59,571,757,0.16776750330251,0.0779392338177015,0.754293262879789
"212","1995-01-20",139,54,538,731,0.19015047879617,0.0738714090287278,0.735978112175103
"213","1995-01-27",131,56,549,736,0.177989130434783,0.0760869565217391,0.745923913043478
"214","1995-02-03",135,52,537,724,0.18646408839779,0.0718232044198895,0.741712707182321
"215","1995-02-10",135,49,522,706,0.191218130311615,0.0694050991501416,0.739376770538244
"216","1995-02-17",143,45,536,724,0.197513812154696,0.0621546961325967,0.740331491712707
"217","1995-02-24",143,43,510,696,0.205459770114943,0.0617816091954023,0.732758620689655
"218","1995-03-03",140,43,501,684,0.204678362573099,0.0628654970760234,0.732456140350877
"219","1995-03-10",141,42,492,675,0.208888888888889,0.0622222222222222,0.728888888888889
"220","1995-03-17",142,46,479,667,0.212893553223388,0.0689655172413793,0.718140929535232
"221","1995-03-24",136,49,467,652,0.208588957055215,0.0751533742331288,0.716257668711656
"222","1995-03-31",134,50,464,648,0.20679012345679,0.0771604938271605,0.716049382716049
"223","1995-04-07",131,48,490,669,0.195814648729447,0.0717488789237668,0.732436472346786
"224","1995-04-13",135,51,490,676,0.199704142011834,0.0754437869822485,0.724852071005917
"225","1995-04-21",136,55,494,685,0.198540145985401,0.0802919708029197,0.721167883211679
"226","1995-04-28",140,58,482,680,0.205882352941176,0.0852941176470588,0.708823529411765
"227","1995-05-05",138,57,469,664,0.207831325301205,0.0858433734939759,0.706325301204819
"228","1995-05-12",145,59,485,689,0.21044992743106,0.0856313497822932,0.703918722786647
"229","1995-05-19",142,59,472,673,0.210995542347697,0.087667161961367,0.701337295690936
"230","1995-05-26",148,57,485,690,0.214492753623188,0.0826086956521739,0.702898550724638
"231","1995-06-02",147,52,478,677,0.217134416543575,0.0768094534711965,0.706056129985229
"232","1995-06-09",151,48,475,674,0.224035608308605,0.0712166172106825,0.704747774480712
"233","1995-06-16",142,49,479,670,0.211940298507463,0.073134328358209,0.714925373134328
"234","1995-06-23",142,48,494,684,0.207602339181287,0.0701754385964912,0.722222222222222
"235","1995-06-30",126,45,495,666,0.189189189189189,0.0675675675675676,0.743243243243243
"236","1995-07-07",141,46,527,714,0.197478991596639,0.0644257703081232,0.738095238095238
"237","1995-07-14",145,50,525,720,0.201388888888889,0.0694444444444444,0.729166666666667
"238","1995-07-21",147,47,525,719,0.204450625869263,0.0653685674547983,0.730180806675939
"239","1995-07-28",148,51,540,739,0.200270635994587,0.0690121786197564,0.730717185385656
"240","1995-08-04",149,50,533,732,0.203551912568306,0.0683060109289617,0.728142076502732
"241","1995-08-11",151,50,538,739,0.204330175913397,0.06765899864682,0.728010825439784
"242","1995-08-18",150,52,542,744,0.201612903225806,0.0698924731182796,0.728494623655914
"243","1995-08-25",151,53,559,763,0.197903014416776,0.0694626474442988,0.732634338138925
"244","1995-09-01",151,52,569,772,0.19559585492228,0.0673575129533679,0.737046632124352
"245","1995-09-08",152,53,561,766,0.198433420365535,0.0691906005221932,0.732375979112272
"246","1995-09-15",151,54,554,759,0.198945981554677,0.0711462450592885,0.729907773386034
"247","1995-09-22",154,55,566,775,0.198709677419355,0.0709677419354839,0.730322580645161
"248","1995-09-29",156,51,548,755,0.206622516556291,0.0675496688741722,0.725827814569536
"249","1995-10-06",152,51,551,754,0.20159151193634,0.0676392572944297,0.730769230769231
"250","1995-10-13",152,51,560,763,0.199213630406291,0.0668414154652687,0.73394495412844
"251","1995-10-20",152,50,563,765,0.198692810457516,0.065359477124183,0.735947712418301
"252","1995-10-27",152,50,559,761,0.199737187910644,0.0657030223390276,0.734559789750328
"253","1995-11-03",143,52,569,764,0.18717277486911,0.0680628272251309,0.744764397905759
"254","1995-11-10",147,52,570,769,0.191157347204161,0.0676202860858258,0.741222366710013
"255","1995-11-17",155,54,570,779,0.198973042362003,0.0693196405648267,0.731707317073171
"256","1995-11-22",156,55,563,774,0.201550387596899,0.0710594315245478,0.727390180878553
"257","1995-12-01",160,58,555,773,0.206985769728331,0.0750323415265201,0.717981888745149
"258","1995-12-08",157,58,557,772,0.203367875647668,0.0751295336787565,0.721502590673575
"259","1995-12-15",158,56,551,765,0.206535947712418,0.073202614379085,0.720261437908497
"260","1995-12-22",162,54,546,762,0.21259842519685,0.0708661417322835,0.716535433070866
"261","1995-12-29",159,52,534,745,0.213422818791946,0.0697986577181208,0.716778523489933
"262","1996-01-05",154,50,507,711,0.216596343178622,0.070323488045007,0.713080168776371
"263","1996-01-12",155,52,497,704,0.220170454545455,0.0738636363636364,0.705965909090909
"264","1996-01-19",155,52,509,716,0.216480446927374,0.0726256983240224,0.710893854748603
"265","1996-01-26",160,49,494,703,0.227596017069701,0.069701280227596,0.702702702702703
"266","1996-02-02",151,48,494,693,0.217893217893218,0.0692640692640693,0.712842712842713
"267","1996-02-09",155,54,486,695,0.223021582733813,0.0776978417266187,0.699280575539568
"268","1996-02-16",155,53,499,707,0.219236209335219,0.074964639321075,0.705799151343706
"269","1996-02-23",158,51,496,705,0.224113475177305,0.0723404255319149,0.70354609929078
"270","1996-03-01",158,56,493,707,0.223479490806223,0.0792079207920792,0.697312588401697
"271","1996-03-08",153,56,510,719,0.212795549374131,0.0778859527121002,0.709318497913769
"272","1996-03-15",143,56,494,693,0.206349206349206,0.0808080808080808,0.712842712842713
"273","1996-03-22",157,54,514,725,0.216551724137931,0.0744827586206897,0.708965517241379
"274","1996-03-29",161,54,513,728,0.221153846153846,0.0741758241758242,0.70467032967033
"275","1996-04-04",168,55,502,725,0.231724137931034,0.0758620689655172,0.692413793103448
"276","1996-04-12",171,53,511,735,0.23265306122449,0.072108843537415,0.695238095238095
"277","1996-04-19",176,55,516,747,0.235609103078983,0.0736278447121821,0.690763052208835
"278","1996-04-26",179,56,522,757,0.236459709379128,0.0739762219286658,0.689564068692206
"279","1996-05-03",173,58,518,749,0.230974632843792,0.0774365821094793,0.691588785046729
"280","1996-05-10",178,59,535,772,0.230569948186529,0.0764248704663213,0.69300518134715
"281","1996-05-17",175,63,519,757,0.231175693527081,0.083223249669749,0.68560105680317
"282","1996-05-24",171,63,541,775,0.220645161290323,0.0812903225806452,0.698064516129032
"283","1996-05-31",173,63,529,765,0.226143790849673,0.0823529411764706,0.691503267973856
"284","1996-06-07",170,57,554,781,0.217669654289373,0.0729833546734955,0.709346991037132
"285","1996-06-14",159,57,557,773,0.205692108667529,0.073738680465718,0.720569210866753
"286","1996-06-21",150,53,562,765,0.196078431372549,0.069281045751634,0.734640522875817
"287","1996-06-28",150,50,577,777,0.193050193050193,0.0643500643500644,0.742599742599743
"288","1996-07-03",146,46,590,782,0.186700767263427,0.0588235294117647,0.754475703324808
"289","1996-07-12",146,46,596,788,0.185279187817259,0.0583756345177665,0.756345177664975
"290","1996-07-19",149,46,595,790,0.188607594936709,0.0582278481012658,0.753164556962025
"291","1996-07-26",155,53,566,774,0.200258397932817,0.0684754521963824,0.731266149870801
"292","1996-08-02",154,55,592,801,0.192259675405743,0.0686641697877653,0.739076154806492
"293","1996-08-09",153,53,603,809,0.189122373300371,0.065512978986403,0.745364647713226
"294","1996-08-16",167,57,581,805,0.207453416149068,0.0708074534161491,0.721739130434783
"295","1996-08-23",169,66,593,828,0.204106280193237,0.0797101449275362,0.716183574879227
"296","1996-08-30",173,66,573,812,0.213054187192118,0.0812807881773399,0.705665024630542
"297","1996-09-06",172,64,554,790,0.217721518987342,0.0810126582278481,0.70126582278481
"298","1996-09-13",175,64,569,808,0.216584158415842,0.0792079207920792,0.704207920792079
"299","1996-09-20",187,59,579,825,0.226666666666667,0.0715151515151515,0.701818181818182
"300","1996-09-27",179,60,583,822,0.217761557177616,0.072992700729927,0.709245742092457
"301","1996-10-04",180,61,578,819,0.21978021978022,0.0744810744810745,0.705738705738706
"302","1996-10-11",158,64,605,827,0.191051995163241,0.0773881499395405,0.731559854897219
"303","1996-10-18",187,67,591,845,0.221301775147929,0.0792899408284024,0.699408284023669
"304","1996-10-25",195,69,589,853,0.228604923798359,0.0808909730363423,0.690504103165299
"305","1996-11-01",197,68,574,839,0.234803337306317,0.0810488676996424,0.684147794994041
"306","1996-11-08",195,70,573,838,0.232696897374702,0.0835322195704057,0.683770883054893
"307","1996-11-15",198,69,582,849,0.23321554770318,0.0812720848056537,0.685512367491166
"308","1996-11-22",189,65,597,851,0.222091656874266,0.0763807285546416,0.701527614571093
"309","1996-11-27",189,64,608,861,0.219512195121951,0.0743321718931475,0.706155632984901
"310","1996-12-06",191,65,600,856,0.223130841121495,0.0759345794392523,0.700934579439252
"311","1996-12-13",183,63,595,841,0.217598097502973,0.0749108204518431,0.707491082045184
"312","1996-12-20",193,62,603,858,0.224941724941725,0.0722610722610723,0.702797202797203
"313","1996-12-27",189,64,598,851,0.222091656874266,0.0752056404230317,0.702702702702703
"314","1997-01-03",184,64,597,845,0.217751479289941,0.0757396449704142,0.706508875739645
"315","1997-01-10",173,60,592,825,0.20969696969697,0.0727272727272727,0.717575757575758
"316","1997-01-17",169,69,580,818,0.206601466992665,0.0843520782396088,0.709046454767726
"317","1997-01-24",171,62,582,815,0.209815950920245,0.0760736196319018,0.714110429447853
"318","1997-01-31",164,62,581,807,0.203221809169765,0.0768277571251549,0.719950433705081
"319","1997-02-07",165,68,600,833,0.198079231692677,0.0816326530612245,0.720288115246098
"320","1997-02-14",158,69,633,860,0.183720930232558,0.0802325581395349,0.736046511627907
"321","1997-02-21",166,67,630,863,0.192352259559676,0.0776361529548088,0.730011587485516
"322","1997-02-28",158,69,613,840,0.188095238095238,0.0821428571428571,0.729761904761905
"323","1997-03-07",196,70,616,882,0.222222222222222,0.0793650793650794,0.698412698412698
"324","1997-03-14",195,72,618,885,0.220338983050847,0.0813559322033898,0.698305084745763
"325","1997-03-21",191,73,641,905,0.211049723756906,0.0806629834254144,0.70828729281768
"326","1997-03-28",191,78,646,915,0.208743169398907,0.0852459016393443,0.706010928961749
"327","1997-04-04",197,74,647,918,0.214596949891068,0.0806100217864924,0.70479302832244
"328","1997-04-11",201,77,635,913,0.220153340635268,0.0843373493975904,0.695509309967141
"329","1997-04-18",197,75,613,885,0.222598870056497,0.0847457627118644,0.692655367231638
"330","1997-04-25",193,77,619,889,0.217097862767154,0.0866141732283465,0.696287964004499
"331","1997-05-02",185,74,622,881,0.209988649262202,0.0839954597048808,0.706015891032917
"332","1997-05-09",197,67,649,913,0.215772179627601,0.0733844468784228,0.710843373493976
"333","1997-05-16",199,64,654,917,0.21701199563795,0.0697928026172301,0.71319520174482
"334","1997-05-23",196,74,678,948,0.206751054852321,0.0780590717299578,0.715189873417722
"335","1997-05-30",197,76,688,961,0.204994797086368,0.0790842872008325,0.715920915712799
"336","1997-06-06",200,75,713,988,0.202429149797571,0.0759109311740891,0.72165991902834
"337","1997-06-13",208,76,698,982,0.211812627291242,0.0773930753564155,0.710794297352342
"338","1997-06-20",202,70,694,966,0.209109730848861,0.072463768115942,0.718426501035197
"339","1997-06-27",215,65,686,966,0.222567287784679,0.067287784679089,0.710144927536232
"340","1997-07-04",214,67,684,965,0.221761658031088,0.0694300518134715,0.70880829015544
"341","1997-07-11",213,71,680,964,0.220954356846473,0.0736514522821577,0.705394190871369
"342","1997-07-18",222,71,669,962,0.230769230769231,0.0738045738045738,0.695426195426195
"343","1997-07-25",223,66,695,984,0.226626016260163,0.0670731707317073,0.70630081300813
"344","1997-08-01",228,68,699,995,0.229145728643216,0.0683417085427136,0.70251256281407
"345","1997-08-08",233,73,681,987,0.236068895643364,0.0739614994934144,0.689969604863222
"346","1997-08-15",238,67,694,999,0.238238238238238,0.0670670670670671,0.694694694694695
"347","1997-08-22",243,60,702,1005,0.241791044776119,0.0597014925373134,0.698507462686567
"348","1997-08-29",234,67,679,980,0.238775510204082,0.0683673469387755,0.692857142857143
"349","1997-09-05",235,71,726,1032,0.227713178294574,0.0687984496124031,0.703488372093023
"350","1997-09-12",236,71,705,1012,0.233201581027668,0.0701581027667984,0.696640316205534
"351","1997-09-19",223,71,699,993,0.224572004028197,0.0715005035246727,0.70392749244713
"352","1997-09-26",219,76,703,998,0.219438877755511,0.0761523046092184,0.704408817635271
"353","1997-10-03",222,82,697,1001,0.221778221778222,0.0819180819180819,0.696303696303696
"354","1997-10-10",217,73,684,974,0.222792607802875,0.0749486652977413,0.702258726899384
"355","1997-10-17",208,70,709,987,0.210739614994934,0.0709219858156028,0.718338399189463
"356","1997-10-24",222,71,710,1003,0.221335992023928,0.0707876370887338,0.707876370887338
"357","1997-10-31",227,70,720,1017,0.223205506391347,0.0688298918387414,0.707964601769912
"358","1997-11-07",227,59,699,985,0.230456852791878,0.0598984771573604,0.709644670050761
"359","1997-11-14",225,59,710,994,0.22635814889336,0.0593561368209256,0.714285714285714
"360","1997-11-21",219,56,672,947,0.231256599788807,0.0591341077085533,0.70960929250264
"361","1997-11-28",227,61,717,1005,0.225870646766169,0.0606965174129353,0.713432835820895
"362","1997-12-05",221,63,730,1014,0.217948717948718,0.0621301775147929,0.719921104536489
"363","1997-12-12",223,66,723,1012,0.220355731225296,0.0652173913043478,0.714426877470356
"364","1997-12-19",235,65,719,1019,0.230618253189401,0.0637880274779195,0.705593719332679
"365","1997-12-26",237,65,705,1007,0.235352532274081,0.0645481628599801,0.700099304865938
"366","1998-01-02",235,58,710,1003,0.234297108673978,0.0578265204386839,0.707876370887338
"367","1998-01-09",234,59,697,990,0.236363636363636,0.0595959595959596,0.704040404040404
"368","1998-01-16",228,60,701,989,0.230535894843276,0.0606673407482305,0.708796764408493
"369","1998-01-23",241,64,691,996,0.241967871485944,0.0642570281124498,0.693775100401606
"370","1998-01-30",244,68,675,987,0.247213779128673,0.0688956433637285,0.683890577507599
"371","1998-02-06",244,68,662,974,0.250513347022587,0.0698151950718686,0.679671457905544
"372","1998-02-13",251,68,653,972,0.258230452674897,0.0699588477366255,0.671810699588477
"373","1998-02-20",256,63,670,989,0.258847320525784,0.0637007077856421,0.677451971688574
"374","1998-02-27",251,57,652,960,0.261458333333333,0.059375,0.679166666666667
"375","1998-03-06",250,53,654,957,0.26123301985371,0.0553814002089864,0.683385579937304
"376","1998-03-13",252,58,632,942,0.267515923566879,0.0615711252653928,0.670912951167728
"377","1998-03-20",248,56,633,937,0.264674493062967,0.0597652081109925,0.675560298826041
"378","1998-03-27",243,58,589,890,0.273033707865169,0.0651685393258427,0.661797752808989
"379","1998-04-03",243,57,575,875,0.277714285714286,0.0651428571428571,0.657142857142857
"380","1998-04-10",239,59,591,889,0.268841394825647,0.0663667041619797,0.664791901012374
"381","1998-04-17",233,59,606,898,0.259465478841871,0.0657015590200445,0.674832962138085
"382","1998-04-24",224,53,603,880,0.254545454545455,0.0602272727272727,0.685227272727273
"383","1998-05-01",218,53,605,876,0.248858447488584,0.0605022831050228,0.690639269406393
"384","1998-05-08",224,54,567,845,0.26508875739645,0.063905325443787,0.671005917159763
"385","1998-05-15",232,52,592,876,0.264840182648402,0.0593607305936073,0.675799086757991
"386","1998-05-22",229,44,582,855,0.267836257309942,0.0514619883040936,0.680701754385965
"387","1998-05-29",218,42,562,822,0.265206812652068,0.0510948905109489,0.683698296836983
"388","1998-06-05",229,47,586,862,0.265661252900232,0.0545243619489559,0.679814385150812
"389","1998-06-12",230,41,597,868,0.264976958525346,0.0472350230414747,0.68778801843318
"390","1998-06-19",225,39,599,863,0.26071842410197,0.0451911935110081,0.694090382387022
"391","1998-06-26",205,38,580,823,0.249088699878493,0.0461725394896719,0.704738760631835
"392","1998-07-03",206,37,569,812,0.253694581280788,0.0455665024630542,0.700738916256158
"393","1998-07-10",204,38,577,819,0.249084249084249,0.0463980463980464,0.704517704517704
"394","1998-07-17",200,35,575,810,0.246913580246914,0.0432098765432099,0.709876543209877
"395","1998-07-24",213,41,562,816,0.261029411764706,0.0502450980392157,0.688725490196079
"396","1998-07-31",205,41,576,822,0.249391727493917,0.0498783454987835,0.700729927007299
"397","1998-08-07",201,34,574,809,0.248454882571075,0.0420271940667491,0.709517923362176
"398","1998-08-14",193,39,567,799,0.241551939924906,0.048811013767209,0.709637046307885
"399","1998-08-21",189,37,545,771,0.245136186770428,0.0479896238651102,0.706874189364462
"400","1998-08-28",203,35,552,790,0.256962025316456,0.0443037974683544,0.69873417721519
"401","1998-09-04",200,32,538,770,0.25974025974026,0.0415584415584416,0.698701298701299
"402","1998-09-11",200,29,552,781,0.256081946222791,0.0371318822023047,0.706786171574904
"403","1998-09-18",198,30,545,773,0.25614489003881,0.0388098318240621,0.705045278137128
"404","1998-09-25",196,30,544,770,0.254545454545455,0.038961038961039,0.706493506493507
"405","1998-10-02",190,31,533,754,0.251989389920424,0.0411140583554377,0.706896551724138
"406","1998-10-09",186,30,534,750,0.248,0.04,0.712
"407","1998-10-16",186,34,520,740,0.251351351351351,0.0459459459459459,0.702702702702703
"408","1998-10-23",183,40,493,716,0.255586592178771,0.0558659217877095,0.68854748603352
"409","1998-10-30",174,38,496,708,0.245762711864407,0.0536723163841808,0.700564971751412
"410","1998-11-06",172,42,482,696,0.247126436781609,0.0603448275862069,0.692528735632184
"411","1998-11-13",168,42,474,684,0.245614035087719,0.0614035087719298,0.692982456140351
"412","1998-11-20",164,43,479,686,0.239067055393586,0.0626822157434402,0.698250728862974
"413","1998-11-27",163,44,479,686,0.237609329446064,0.0641399416909621,0.698250728862974
"414","1998-12-04",160,41,468,669,0.239162929745889,0.0612855007473842,0.699551569506726
"415","1998-12-11",163,37,467,667,0.244377811094453,0.055472263868066,0.700149925037481
"416","1998-12-18",157,38,447,642,0.244548286604361,0.059190031152648,0.696261682242991
"417","1998-12-23",155,41,438,634,0.244479495268139,0.0646687697160883,0.690851735015773
"418","1998-12-30",161,41,419,621,0.259259259259259,0.0660225442834139,0.674718196457327
"419","1999-01-08",156,42,402,600,0.26,0.07,0.67
"420","1999-01-15",157,40,400,597,0.262981574539363,0.067001675041876,0.67001675041876
"421","1999-01-22",154,36,398,588,0.261904761904762,0.0612244897959184,0.67687074829932
"422","1999-01-29",155,32,375,562,0.275800711743772,0.0569395017793594,0.667259786476868
"423","1999-02-05",146,36,376,558,0.261648745519713,0.0645161290322581,0.673835125448029
"424","1999-02-12",144,35,365,544,0.264705882352941,0.0643382352941176,0.670955882352941
"425","1999-02-19",149,38,344,531,0.28060263653484,0.0715630885122411,0.647834274952919
"426","1999-02-26",150,35,348,533,0.281425891181989,0.0656660412757974,0.652908067542214
"427","1999-03-05",159,33,349,541,0.293900184842884,0.0609981515711645,0.645101663585952
"428","1999-03-12",159,32,343,534,0.297752808988764,0.0599250936329588,0.642322097378277
"429","1999-03-19",156,33,337,526,0.296577946768061,0.0627376425855513,0.640684410646388
"430","1999-03-26",151,31,320,502,0.300796812749004,0.0617529880478088,0.637450199203187
"431","1999-04-02",149,29,325,503,0.296222664015905,0.0576540755467197,0.646123260437376
"432","1999-04-09",143,30,325,498,0.28714859437751,0.0602409638554217,0.652610441767068
"433","1999-04-16",150,29,320,499,0.30060120240481,0.0581162324649299,0.64128256513026
"434","1999-04-23",155,32,301,488,0.317622950819672,0.0655737704918033,0.616803278688525
"435","1999-04-30",155,32,307,494,0.313765182186235,0.0647773279352227,0.621457489878543
"436","1999-05-07",154,35,316,505,0.304950495049505,0.0693069306930693,0.625742574257426
"437","1999-05-14",150,33,324,507,0.29585798816568,0.0650887573964497,0.63905325443787
"438","1999-05-21",155,31,332,518,0.299227799227799,0.0598455598455599,0.640926640926641
"439","1999-05-28",157,30,347,534,0.294007490636704,0.0561797752808989,0.649812734082397
"440","1999-06-04",159,30,366,555,0.286486486486487,0.0540540540540541,0.659459459459459
"441","1999-06-11",155,31,361,547,0.283363802559415,0.056672760511883,0.659963436928702
"442","1999-06-18",163,32,371,566,0.287985865724382,0.0565371024734982,0.65547703180212
"443","1999-06-25",159,38,366,563,0.282415630550622,0.0674955595026643,0.650088809946714
"444","1999-07-02",158,42,380,580,0.272413793103448,0.0724137931034483,0.655172413793103
"445","1999-07-09",155,43,372,570,0.271929824561404,0.0754385964912281,0.652631578947368
"446","1999-07-16",156,40,387,583,0.267581475128645,0.0686106346483705,0.663807890222985
"447","1999-07-23",151,41,413,605,0.249586776859504,0.0677685950413223,0.682644628099174
"448","1999-07-30",144,43,415,602,0.239202657807309,0.0714285714285714,0.68936877076412
"449","1999-08-06",144,43,429,616,0.233766233766234,0.0698051948051948,0.696428571428571
"450","1999-08-13",145,36,446,627,0.231259968102073,0.0574162679425837,0.711323763955343
"451","1999-08-20",152,36,457,645,0.235658914728682,0.0558139534883721,0.708527131782946
"452","1999-08-27",145,45,478,668,0.217065868263473,0.0673652694610778,0.715568862275449
"453","1999-09-03",150,44,477,671,0.22354694485842,0.0655737704918033,0.710879284649776
"454","1999-09-10",161,39,490,690,0.233333333333333,0.0565217391304348,0.710144927536232
"455","1999-09-17",154,42,507,703,0.219061166429588,0.0597439544807966,0.721194879089616
"456","1999-09-24",164,48,508,720,0.227777777777778,0.0666666666666667,0.705555555555556
"457","1999-10-01",168,45,517,730,0.23013698630137,0.0616438356164384,0.708219178082192
"458","1999-10-08",166,42,533,741,0.224021592442645,0.0566801619433198,0.719298245614035
"459","1999-10-15",168,42,511,721,0.233009708737864,0.058252427184466,0.70873786407767
"460","1999-10-22",172,44,534,750,0.229333333333333,0.0586666666666667,0.712
"461","1999-10-29",171,45,545,761,0.224704336399474,0.0591327201051248,0.716162943495401
"462","1999-11-05",175,48,540,763,0.229357798165138,0.0629095674967235,0.707732634338139
"463","1999-11-12",178,49,547,774,0.229974160206718,0.0633074935400517,0.70671834625323
"464","1999-11-19",180,46,571,797,0.225846925972397,0.0577164366373902,0.716436637390213
"465","1999-11-26",185,51,559,795,0.232704402515723,0.0641509433962264,0.70314465408805
"466","1999-12-03",180,51,565,796,0.226130653266332,0.064070351758794,0.709798994974874
"467","1999-12-10",178,51,584,813,0.218942189421894,0.0627306273062731,0.718327183271833
"468","1999-12-17",182,51,582,815,0.223312883435583,0.0625766871165644,0.714110429447853
"469","1999-12-22",171,50,576,797,0.214554579673777,0.0627352572145546,0.722710163111669
"470","1999-12-30",172,48,551,771,0.223086900129702,0.0622568093385214,0.714656290531777
"471","2000-01-07",165,51,570,786,0.209923664122137,0.0648854961832061,0.725190839694656
"472","2000-01-14",169,52,560,781,0.216389244558259,0.0665813060179257,0.717029449423816
"473","2000-01-21",177,51,549,777,0.227799227799228,0.0656370656370656,0.706563706563707
"474","2000-01-28",176,56,523,755,0.233112582781457,0.0741721854304636,0.692715231788079
"475","2000-02-04",184,57,516,757,0.243064729194188,0.0752972258916777,0.681638044914135
"476","2000-02-11",178,58,526,762,0.233595800524934,0.0761154855643045,0.690288713910761
"477","2000-02-18",184,59,530,773,0.238033635187581,0.0763260025873221,0.685640362225097
"478","2000-02-25",191,54,515,760,0.251315789473684,0.0710526315789474,0.677631578947368
"479","2000-03-03",195,51,544,790,0.246835443037975,0.0645569620253165,0.688607594936709
"480","2000-03-10",189,46,533,768,0.24609375,0.0598958333333333,0.694010416666667
"481","2000-03-17",183,43,538,764,0.239528795811518,0.056282722513089,0.704188481675393
"482","2000-03-24",191,41,536,768,0.248697916666667,0.0533854166666667,0.697916666666667
"483","2000-03-31",196,45,534,775,0.252903225806452,0.0580645161290323,0.689032258064516
"484","2000-04-07",200,47,550,797,0.250941028858218,0.0589711417816813,0.6900878293601
"485","2000-04-14",199,48,562,809,0.245982694684796,0.0593325092707046,0.694684796044499
"486","2000-04-20",197,47,573,817,0.241126070991432,0.0575275397796818,0.701346389228886
"487","2000-04-28",197,47,554,798,0.2468671679198,0.0588972431077694,0.694235588972431
"488","2000-05-05",205,48,580,833,0.24609843937575,0.0576230492196879,0.696278511404562
"489","2000-05-12",209,46,575,830,0.251807228915663,0.055421686746988,0.692771084337349
"490","2000-05-19",210,47,592,849,0.247349823321555,0.055359246171967,0.697290930506478
"491","2000-05-26",210,44,610,864,0.243055555555556,0.0509259259259259,0.706018518518518
"492","2000-06-02",212,48,606,866,0.244803695150115,0.0554272517321016,0.699769053117783
"493","2000-06-09",202,44,594,840,0.24047619047619,0.0523809523809524,0.707142857142857
"494","2000-06-16",210,50,611,871,0.241102181400689,0.0574052812858783,0.701492537313433
"495","2000-06-23",223,55,615,893,0.249720044792833,0.0615901455767077,0.688689809630459
"496","2000-06-30",229,61,630,920,0.248913043478261,0.066304347826087,0.684782608695652
"497","2000-07-07",229,60,624,913,0.250821467688938,0.0657174151150055,0.683461117196057
"498","2000-07-14",236,62,630,928,0.254310344827586,0.0668103448275862,0.678879310344828
"499","2000-07-15",236,62,630,928,0.254310344827586,0.0668103448275862,0.678879310344828
"500","2000-07-28",245,56,674,975,0.251282051282051,0.0574358974358974,0.691282051282051
"501","2000-08-04",243,57,681,981,0.247706422018349,0.0581039755351682,0.694189602446483
"502","2000-08-11",241,55,680,976,0.246926229508197,0.0563524590163934,0.69672131147541
"503","2000-08-18",245,57,692,994,0.246478873239437,0.0573440643863179,0.696177062374245
"504","2000-08-25",237,59,700,996,0.237951807228916,0.0592369477911647,0.70281124497992
"505","2000-09-01",227,62,730,1019,0.222767419038273,0.0608439646712463,0.716388616290481
"506","2000-09-08",217,59,736,1012,0.214426877470356,0.058300395256917,0.727272727272727
"507","2000-09-15",214,64,734,1012,0.211462450592885,0.0632411067193676,0.725296442687747
"508","2000-09-22",202,63,733,998,0.202404809619238,0.06312625250501,0.734468937875752
"509","2000-09-29",216,64,735,1015,0.212807881773399,0.0630541871921182,0.724137931034483
"510","2000-10-06",228,62,745,1035,0.220289855072464,0.0599033816425121,0.719806763285024
"511","2000-10-13",225,59,761,1045,0.215311004784689,0.0564593301435407,0.72822966507177
"512","2000-10-20",237,63,754,1054,0.224857685009488,0.0597722960151803,0.715370018975332
"513","2000-10-27",244,63,777,1084,0.225092250922509,0.0581180811808118,0.716789667896679
"514","2000-11-03",250,68,760,1078,0.23191094619666,0.0630797773654917,0.705009276437848
"515","2000-11-10",252,65,750,1067,0.236176194939082,0.0609184629803187,0.7029053420806
"516","2000-11-17",254,62,741,1057,0.240302743614002,0.0586565752128666,0.701040681173132
"517","2000-11-22",247,63,754,1064,0.232142857142857,0.0592105263157895,0.708646616541353
"518","2000-12-01",252,65,773,1090,0.231192660550459,0.0596330275229358,0.709174311926606
"519","2000-12-08",253,65,770,1088,0.232536764705882,0.0597426470588235,0.707720588235294
"520","2000-12-15",257,61,789,1107,0.232158988256549,0.0551038843721771,0.712737127371274
"521","2000-12-21",256,55,776,1087,0.235510579576817,0.0505979760809568,0.713891444342226
"522","2000-12-29",260,57,797,1114,0.233393177737881,0.0511669658886894,0.715439856373429
"523","2001-01-05",262,60,785,1107,0.236675700090334,0.0542005420054201,0.709123757904246
"524","2001-01-12",269,61,791,1121,0.239964317573595,0.0544157002676182,0.705619982158787
"525","2001-01-19",265,57,806,1128,0.234929078014184,0.050531914893617,0.714539007092199
"526","2001-01-26",251,68,797,1116,0.224910394265233,0.0609318996415771,0.71415770609319
"527","2001-02-02",256,69,813,1138,0.224956063268893,0.0606326889279438,0.714411247803163
"528","2001-02-09",263,72,802,1137,0.231310466138962,0.0633245382585752,0.705364995602463
"529","2001-02-16",268,67,812,1147,0.233653007846556,0.0584132519616391,0.707933740191805
"530","2001-02-23",263,66,792,1121,0.234611953612846,0.0588760035682426,0.706512042818912
"531","2001-03-02",260,68,823,1151,0.225890529973936,0.0590790616854909,0.715030408340573
"532","2001-03-09",271,74,813,1158,0.234024179620035,0.0639032815198618,0.702072538860104
"533","2001-03-16",276,71,804,1151,0.239791485664639,0.0616854908774978,0.698523023457863
"534","2001-03-23",271,76,816,1163,0.233018056749785,0.0653482373172829,0.701633705932932
"535","2001-03-30",291,80,822,1193,0.243922883487008,0.0670578373847443,0.689019279128248
"536","2001-04-06",297,78,825,1200,0.2475,0.065,0.6875
"537","2001-04-12",282,81,835,1198,0.235392320534224,0.0676126878130217,0.696994991652755
"538","2001-04-20",283,72,858,1213,0.233305853256389,0.0593569661995054,0.707337180544106
"539","2001-04-27",289,71,852,1212,0.238448844884488,0.0585808580858086,0.702970297029703
"540","2001-05-04",301,79,837,1217,0.247329498767461,0.0649137222678718,0.687756778964667
"541","2001-05-11",311,85,836,1232,0.252435064935065,0.0689935064935065,0.678571428571429
"542","2001-05-18",308,83,834,1225,0.251428571428571,0.0677551020408163,0.680816326530612
"543","2001-05-25",316,81,865,1262,0.250396196513471,0.0641838351822504,0.685419968304279
"544","2001-06-01",314,84,872,1270,0.247244094488189,0.0661417322834646,0.686614173228346
"545","2001-06-08",319,82,863,1264,0.252373417721519,0.064873417721519,0.682753164556962
"546","2001-06-15",311,83,872,1266,0.24565560821485,0.0655608214849921,0.688783570300158
"547","2001-06-22",306,84,887,1277,0.239624119028974,0.0657791699295223,0.694596711041504
"548","2001-06-29",307,79,889,1275,0.24078431372549,0.0619607843137255,0.697254901960784
"549","2001-07-06",303,78,894,1275,0.237647058823529,0.0611764705882353,0.701176470588235
"550","2001-07-13",307,82,904,1293,0.237432327919567,0.0634184068058778,0.699149265274555
"551","2001-07-20",303,84,891,1278,0.237089201877934,0.0657276995305164,0.697183098591549
"552","2001-07-27",303,84,879,1266,0.239336492890995,0.0663507109004739,0.694312796208531
"553","2001-08-03",310,82,874,1266,0.244865718799368,0.0647709320695103,0.690363349131122
"554","2001-08-10",302,81,865,1248,0.24198717948718,0.0649038461538462,0.693108974358974
"555","2001-08-17",297,82,863,1242,0.239130434782609,0.0660225442834139,0.694847020933978
"556","2001-08-24",297,87,867,1251,0.237410071942446,0.0695443645083933,0.693045563549161
"557","2001-08-31",289,84,879,1252,0.230830670926518,0.0670926517571885,0.702076677316294
"558","2001-09-07",295,87,834,1216,0.242598684210526,0.071546052631579,0.685855263157895
"559","2001-09-14",290,87,825,1202,0.24126455906822,0.0723793677204659,0.686356073211315
"560","2001-09-21",288,86,812,1186,0.24283305227656,0.0725126475548061,0.684654300168634
"561","2001-09-28",289,82,797,1168,0.247431506849315,0.0702054794520548,0.68236301369863
"562","2001-10-05",279,83,779,1141,0.244522348816827,0.0727432077125329,0.68273444347064
"563","2001-10-12",285,77,779,1141,0.249780893952673,0.0674846625766871,0.68273444347064
"564","2001-10-19",275,74,751,1100,0.25,0.0672727272727273,0.682727272727273
"565","2001-10-26",270,73,720,1063,0.253998118532455,0.0686735653809972,0.677328316086548
"566","2001-11-02",266,78,714,1058,0.251417769376181,0.0737240075614367,0.674858223062382
"567","2001-11-09",252,76,682,1010,0.249504950495049,0.0752475247524753,0.675247524752475
"568","2001-11-16",249,76,668,993,0.250755287009063,0.0765357502517623,0.672708962739174
"569","2001-11-21",253,73,660,986,0.256592292089249,0.0740365111561866,0.669371196754564
"570","2001-11-30",252,72,628,952,0.264705882352941,0.0756302521008403,0.659663865546218
"571","2001-12-07",250,74,604,928,0.269396551724138,0.0797413793103448,0.650862068965517
"572","2001-12-14",240,72,595,907,0.264608599779493,0.0793825799338479,0.656008820286659
"573","2001-12-21",225,70,587,882,0.255102040816327,0.0793650793650794,0.665532879818594
"574","2001-12-28",232,72,583,887,0.261555806087937,0.0811724915445321,0.657271702367531
"575","2002-01-04",229,69,585,883,0.259343148357871,0.0781426953567384,0.662514156285391
"576","2002-01-11",218,66,572,856,0.254672897196262,0.0771028037383178,0.668224299065421
"577","2002-01-18",232,65,572,869,0.266973532796318,0.0747986191024166,0.658227848101266
"578","2002-01-25",232,61,566,859,0.270081490104773,0.0710128055878929,0.658905704307334
"579","2002-02-01",226,61,566,853,0.264947245017585,0.0715123094958968,0.663540445486518
"580","2002-02-08",235,57,546,838,0.280429594272076,0.0680190930787589,0.651551312649165
"581","2002-02-15",243,54,518,815,0.298159509202454,0.0662576687116564,0.63558282208589
"582","2002-02-22",224,55,513,792,0.282828282828283,0.0694444444444444,0.647727272727273
"583","2002-03-01",226,54,502,782,0.289002557544757,0.0690537084398977,0.641943734015345
"584","2002-03-08",227,53,489,769,0.29518855656697,0.0689206762028609,0.635890767230169
"585","2002-03-15",220,52,481,753,0.292164674634794,0.0690571049136786,0.638778220451527
"586","2002-03-22",219,55,476,750,0.292,0.0733333333333333,0.634666666666667
"587","2002-03-28",224,58,479,761,0.294349540078844,0.076215505913272,0.629434954007884
"588","2002-04-05",224,56,458,738,0.303523035230352,0.0758807588075881,0.62059620596206
"589","2002-04-12",212,59,476,747,0.28380187416332,0.0789825970548862,0.637215528781794
"590","2002-04-19",204,56,489,749,0.272363150867824,0.0747663551401869,0.652870493991989
"591","2002-04-26",210,58,498,766,0.274151436031332,0.0757180156657963,0.650130548302872
"592","2002-05-03",210,59,507,776,0.270618556701031,0.0760309278350516,0.653350515463918
"593","2002-05-10",209,65,538,812,0.257389162561576,0.0800492610837438,0.66256157635468
"594","2002-05-17",217,64,548,829,0.261761158021713,0.0772014475271411,0.661037394451146
"595","2002-05-24",231,64,564,859,0.268917345750873,0.0745052386495926,0.656577415599534
"596","2002-05-31",228,65,561,854,0.266978922716628,0.0761124121779859,0.656908665105386
"597","2002-06-07",235,69,543,847,0.277449822904368,0.0814639905548997,0.641086186540732
"598","2002-06-14",235,66,543,844,0.278436018957346,0.0781990521327014,0.643364928909953
"599","2002-06-21",235,69,534,838,0.280429594272076,0.0823389021479714,0.637231503579952
"600","2002-06-28",243,68,529,840,0.289285714285714,0.0809523809523809,0.629761904761905
"601","2002-07-03",252,64,546,862,0.292343387470998,0.074245939675174,0.633410672853828
"602","2002-07-12",248,57,543,848,0.292452830188679,0.0672169811320755,0.640330188679245
"603","2002-07-19",246,59,554,859,0.286379511059371,0.0686845168800931,0.644935972060536
"604","2002-07-26",233,60,540,833,0.279711884753902,0.0720288115246098,0.648259303721489
"605","2002-08-02",237,60,551,848,0.279481132075472,0.0707547169811321,0.649764150943396
"606","2002-08-09",232,55,567,854,0.271662763466042,0.0644028103044497,0.663934426229508
"607","2002-08-16",229,57,567,853,0.268464243845252,0.0668229777256741,0.664712778429074
"608","2002-08-23",227,54,557,838,0.270883054892601,0.0644391408114559,0.664677804295943
"609","2002-08-30",227,58,562,847,0.268004722550177,0.0684769775678867,0.663518299881936
"610","2002-09-06",231,58,562,851,0.27144535840188,0.0681551116333725,0.660399529964747
"611","2002-09-13",241,58,564,863,0.279258400926999,0.06720741599073,0.653534183082271
"612","2002-09-20",235,58,559,852,0.275821596244131,0.068075117370892,0.656103286384977
"613","2002-09-27",232,64,579,875,0.265142857142857,0.0731428571428571,0.661714285714286
"614","2002-10-04",226,66,565,857,0.263710618436406,0.0770128354725788,0.659276546091015
"615","2002-10-11",222,65,562,849,0.261484098939929,0.0765606595995289,0.661955241460542
"616","2002-10-18",226,67,550,843,0.268090154211151,0.0794780545670225,0.652431791221827
"617","2002-10-25",220,66,570,856,0.257009345794392,0.0771028037383178,0.66588785046729
"618","2002-11-01",219,63,572,854,0.256440281030445,0.0737704918032787,0.669789227166276
"619","2002-11-08",209,62,555,826,0.253026634382567,0.0750605326876513,0.671912832929782
"620","2002-11-15",217,61,552,830,0.26144578313253,0.0734939759036145,0.665060240963855
"621","2002-11-22",215,59,552,826,0.260290556900726,0.0714285714285714,0.668280871670702
"622","2002-11-27",218,56,561,835,0.261077844311377,0.067065868263473,0.67185628742515
"623","2002-12-06",223,55,574,852,0.261737089201878,0.0645539906103286,0.673708920187793
"624","2002-12-13",212,55,583,850,0.249411764705882,0.0647058823529412,0.685882352941176
"625","2002-12-20",221,59,580,860,0.256976744186047,0.0686046511627907,0.674418604651163
"626","2002-12-27",225,58,579,862,0.261020881670534,0.0672853828306265,0.67169373549884
"627","2003-01-03",224,57,556,837,0.267622461170848,0.0681003584229391,0.664277180406213
"628","2003-01-10",221,59,571,851,0.259694477085781,0.0693301997649824,0.670975323149236
"629","2003-01-17",230,54,561,845,0.272189349112426,0.063905325443787,0.663905325443787
"630","2003-01-24",234,54,574,862,0.271461716937355,0.0626450116009281,0.665893271461717
"631","2003-01-31",236,58,579,873,0.270332187857961,0.0664375715922108,0.663230240549828
"632","2003-02-07",237,56,591,884,0.268099547511312,0.0633484162895928,0.668552036199095
"633","2003-02-14",235,54,616,905,0.259668508287293,0.0596685082872928,0.680662983425414
"634","2003-02-21",242,54,632,928,0.260775862068966,0.0581896551724138,0.681034482758621
"635","2003-02-28",238,58,616,912,0.260964912280702,0.0635964912280702,0.675438596491228
"636","2003-03-07",236,61,632,929,0.254036598493003,0.0656620021528525,0.680301399354144
"637","2003-03-14",240,60,627,927,0.258899676375405,0.0647249190938511,0.676375404530744
"638","2003-03-21",243,62,641,946,0.256871035940803,0.06553911205074,0.677589852008457
"639","2003-03-28",242,64,656,962,0.251559251559252,0.0665280665280665,0.681912681912682
"640","2003-04-04",238,66,668,972,0.244855967078189,0.0679012345679012,0.687242798353909
"641","2003-04-11",233,65,681,979,0.237997957099081,0.0663942798774259,0.695607763023493
"642","2003-04-17",246,65,683,994,0.24748490945674,0.0653923541247485,0.687122736418511
"643","2003-04-25",251,67,668,986,0.254563894523327,0.0679513184584178,0.677484787018256
"644","2003-05-02",264,65,672,1001,0.263736263736264,0.0649350649350649,0.671328671328671
"645","2003-05-09",268,66,687,1021,0.262487757100881,0.0646425073457395,0.672869735553379
"646","2003-05-16",269,75,696,1040,0.258653846153846,0.0721153846153846,0.669230769230769
"647","2003-05-23",271,70,709,1050,0.258095238095238,0.0666666666666667,0.675238095238095
"648","2003-05-30",281,73,705,1059,0.265344664778093,0.068932955618508,0.665722379603399
"649","2003-06-06",269,83,702,1054,0.255218216318786,0.0787476280834915,0.666034155597723
"650","2003-06-13",272,92,707,1071,0.253968253968254,0.0859010270774977,0.660130718954248
"651","2003-06-20",270,87,710,1067,0.253045923149016,0.0815370196813496,0.665417057169635
"652","2003-06-27",270,85,719,1074,0.251396648044693,0.0791433891992551,0.669459962756052
"653","2003-07-03",276,89,712,1077,0.256267409470752,0.0826369545032498,0.661095636025998
"654","2003-07-11",267,96,702,1065,0.250704225352113,0.0901408450704225,0.659154929577465
"655","2003-07-18",272,93,724,1089,0.249770431588613,0.0853994490358127,0.664830119375574
"656","2003-07-25",277,96,718,1091,0.253895508707608,0.0879926672777269,0.658111824014666
"657","2003-08-01",288,95,714,1097,0.26253418413856,0.0865998176845943,0.650865998176846
"658","2003-08-08",289,96,689,1074,0.269087523277467,0.0893854748603352,0.641527001862197
"659","2003-08-15",287,102,707,1096,0.261861313868613,0.0930656934306569,0.64507299270073
"660","2003-08-22",281,105,696,1082,0.259704251386322,0.0970425138632163,0.643253234750462
"661","2003-08-29",282,102,718,1102,0.255898366606171,0.0925589836660617,0.651542649727768
"662","2003-09-05",274,92,725,1091,0.251145737855179,0.0843263061411549,0.664527956003666
"663","2003-09-12",284,92,719,1095,0.259360730593607,0.0840182648401826,0.65662100456621
"664","2003-09-19",285,91,716,1092,0.260989010989011,0.0833333333333333,0.655677655677656
"665","2003-09-20",285,91,716,1092,0.260989010989011,0.0833333333333333,0.655677655677656
"666","2003-09-27",284,90,721,1095,0.259360730593607,0.0821917808219178,0.658447488584475
"667","2003-10-10",273,89,747,1109,0.246167718665464,0.0802524797114518,0.673579801623084
"668","2003-10-17",268,94,753,1115,0.240358744394619,0.084304932735426,0.675336322869955
"669","2003-10-24",253,93,744,1090,0.232110091743119,0.0853211009174312,0.68256880733945
"670","2003-10-31",258,97,752,1107,0.233062330623306,0.0876242095754291,0.679313459801265
"671","2003-11-07",272,100,742,1114,0.244165170556553,0.0897666068222621,0.666068222621185
"672","2003-11-14",280,99,732,1111,0.252025202520252,0.0891089108910891,0.658865886588659
"673","2003-11-21",269,98,740,1107,0.242999096657633,0.0885275519421861,0.668473351400181
"674","2003-11-26",271,94,748,1113,0.243486073674753,0.0844564240790656,0.672057502246182
"675","2003-12-05",273,96,742,1111,0.245724572457246,0.0864086408640864,0.667866786678668
"676","2003-12-12",274,98,737,1109,0.247069431920649,0.0883678990081154,0.664562669071235
"677","2003-12-19",269,99,744,1112,0.241906474820144,0.0890287769784173,0.669064748201439
"678","2003-12-23",265,98,751,1114,0.237881508078995,0.0879712746858169,0.674147217235188
"679","2003-12-31",283,98,745,1126,0.251332149200711,0.0870337477797513,0.661634103019538
"680","2004-01-09",277,92,737,1106,0.250452079566004,0.0831826401446655,0.666365280289331
"681","2004-01-16",288,89,750,1127,0.255545696539485,0.0789707187222715,0.665483584738243
"682","2004-01-23",267,96,724,1087,0.245630174793008,0.0883164673413064,0.666053357865685
"683","2004-01-30",268,94,722,1084,0.247232472324723,0.0867158671586716,0.666051660516605
"684","2004-02-06",292,95,730,1117,0.261414503133393,0.0850492390331244,0.653536257833483
"685","2004-02-13",285,98,728,1111,0.256525652565257,0.0882088208820882,0.655265526552655
"686","2004-02-20",289,95,730,1114,0.259425493716337,0.085278276481149,0.655296229802513
"687","2004-02-27",293,101,740,1134,0.258377425044092,0.0890652557319224,0.652557319223986
"688","2004-03-05",302,91,736,1129,0.267493356953056,0.0806023029229407,0.651904340124004
"689","2004-03-12",298,98,738,1134,0.262786596119929,0.0864197530864197,0.650793650793651
"690","2004-03-19",295,94,739,1128,0.261524822695035,0.0833333333333333,0.655141843971631
"691","2004-03-26",289,103,758,1150,0.251304347826087,0.0895652173913044,0.659130434782609
"692","2004-04-02",303,96,761,1160,0.261206896551724,0.0827586206896552,0.656034482758621
"693","2004-04-08",285,103,750,1138,0.250439367311072,0.0905096660808436,0.659050966608084
"694","2004-04-16",289,106,755,1150,0.251304347826087,0.0921739130434783,0.656521739130435
"695","2004-04-23",283,108,755,1146,0.24694589877836,0.0942408376963351,0.658813263525305
"696","2004-04-30",284,110,767,1161,0.244616709732989,0.0947459086993971,0.660637381567614
"697","2004-05-07",284,111,758,1153,0.246313963573287,0.0962705984388552,0.657415437987858
"698","2004-05-14",282,115,765,1162,0.242685025817556,0.0989672977624785,0.658347676419966
"699","2004-05-21",287,124,761,1172,0.244880546075085,0.10580204778157,0.649317406143345
"700","2004-05-28",284,125,760,1169,0.242942686056459,0.106928999144568,0.650128314798973
"701","2004-06-04",305,124,739,1168,0.261130136986301,0.106164383561644,0.632705479452055
"702","2004-06-11",312,131,744,1187,0.26284751474305,0.110362257792755,0.626790227464195
"703","2004-06-18",316,133,722,1171,0.269854824935952,0.113578138343296,0.616567036720752
"704","2004-06-25",321,133,722,1176,0.272959183673469,0.113095238095238,0.613945578231293
"705","2004-07-02",326,133,742,1201,0.271440466278102,0.110741049125729,0.61781848459617
"706","2004-07-09",330,137,740,1207,0.273405136702568,0.113504556752278,0.613090306545153
"707","2004-07-16",341,135,735,1211,0.281585466556565,0.111478117258464,0.606936416184971
"708","2004-07-23",333,126,757,1216,0.273848684210526,0.103618421052632,0.622532894736842
"709","2004-07-30",323,135,771,1229,0.262815296989422,0.109845402766477,0.627339300244101
"710","2004-08-06",318,142,775,1235,0.25748987854251,0.11497975708502,0.62753036437247
"711","2004-08-13",324,151,757,1232,0.262987012987013,0.122564935064935,0.614448051948052
"712","2004-08-20",324,150,756,1230,0.263414634146341,0.121951219512195,0.614634146341463
"713","2004-08-27",321,144,774,1239,0.2590799031477,0.116222760290557,0.624697336561743
"714","2004-09-03",329,134,786,1249,0.263410728582866,0.10728582866293,0.629303442754203
"715","2004-09-10",330,133,777,1240,0.266129032258065,0.107258064516129,0.626612903225807
"716","2004-09-17",328,123,781,1232,0.266233766233766,0.0998376623376623,0.633928571428571
"717","2004-09-24",336,116,787,1239,0.271186440677966,0.0936238902340597,0.635189669087974
"718","2004-10-01",331,120,792,1243,0.266291230893001,0.0965406275140789,0.63716814159292
"719","2004-10-08",337,123,770,1230,0.273983739837398,0.1,0.626016260162602
"720","2004-10-15",334,125,766,1225,0.27265306122449,0.102040816326531,0.62530612244898
"721","2004-10-22",341,129,780,1250,0.2728,0.1032,0.624
"722","2004-10-29",331,133,787,1251,0.264588329336531,0.106314948041567,0.629096722621903
"723","2004-11-05",339,132,797,1268,0.267350157728707,0.10410094637224,0.628548895899054
"724","2004-11-12",341,128,790,1259,0.270849880857824,0.101667990468626,0.62748212867355
"725","2004-11-19",346,127,795,1268,0.272870662460568,0.100157728706625,0.626971608832808
"726","2004-11-24",340,123,788,1251,0.271782573940847,0.0983213429256595,0.629896083133493
"727","2004-12-03",328,125,792,1245,0.263453815261044,0.100401606425703,0.636144578313253
"728","2004-12-10",324,127,799,1250,0.2592,0.1016,0.6392
"729","2004-12-17",315,126,793,1234,0.255267423014587,0.102106969205835,0.642625607779579
"730","2004-12-23",314,132,811,1257,0.249801113762928,0.105011933174224,0.645186953062848
"731","2004-12-31",312,128,803,1243,0.251005631536605,0.102976669348351,0.646017699115044
"732","2005-01-07",310,127,805,1242,0.249597423510467,0.102254428341385,0.648148148148148
"733","2005-01-14",321,131,806,1258,0.25516693163752,0.104133545310016,0.640699523052464
"734","2005-01-21",324,141,798,1263,0.256532066508314,0.111638954869359,0.631828978622328
"735","2005-01-28",331,135,790,1256,0.263535031847134,0.107484076433121,0.628980891719745
"736","2005-02-04",324,134,790,1248,0.259615384615385,0.107371794871795,0.63301282051282
"737","2005-02-11",339,145,796,1280,0.26484375,0.11328125,0.621875
"738","2005-02-18",353,147,795,1295,0.272586872586873,0.113513513513514,0.613899613899614
"739","2005-02-25",356,149,776,1281,0.277907884465261,0.116315378610461,0.605776736924278
"740","2005-03-04",345,152,793,1290,0.267441860465116,0.117829457364341,0.614728682170543
"741","2005-03-11",347,154,781,1282,0.270670826833073,0.1201248049922,0.609204368174727
"742","2005-03-18",347,158,815,1320,0.262878787878788,0.11969696969697,0.617424242424242
"743","2005-03-24",342,161,828,1331,0.25694966190834,0.120961682945154,0.622088655146506
"744","2005-04-01",345,164,820,1329,0.259593679458239,0.123401053423627,0.617005267118134
"745","2005-04-08",338,166,823,1327,0.254709871891485,0.12509419743783,0.620195930670686
"746","2005-04-15",334,164,850,1348,0.247774480712166,0.121661721068249,0.630563798219585
"747","2005-04-22",321,165,857,1343,0.239017125837677,0.122859270290395,0.638123603871929
"748","2005-04-29",316,167,842,1325,0.238490566037736,0.126037735849057,0.635471698113208
"749","2005-05-06",315,171,838,1324,0.237915407854985,0.129154078549849,0.632930513595166
"750","2005-05-13",307,170,831,1308,0.234709480122324,0.129969418960245,0.635321100917431
"751","2005-05-20",309,176,830,1315,0.234980988593156,0.13384030418251,0.631178707224335
"752","2005-05-27",329,168,834,1331,0.247182569496619,0.126220886551465,0.626596543951916
"753","2005-06-03",333,176,844,1353,0.246119733924612,0.130081300813008,0.62379896526238
"754","2005-06-10",324,168,847,1339,0.241971620612397,0.125466766243465,0.632561613144138
"755","2005-06-17",329,181,848,1358,0.242268041237113,0.133284241531664,0.624447717231222
"756","2005-06-24",331,182,857,1370,0.241605839416058,0.132846715328467,0.625547445255474
"757","2005-07-01",333,183,854,1370,0.243065693430657,0.133576642335766,0.623357664233577
"758","2005-07-08",335,185,874,1394,0.240315638450502,0.132711621233859,0.626972740315639
"759","2005-07-15",344,183,877,1404,0.245014245014245,0.13034188034188,0.624643874643875
"760","2005-07-22",355,173,882,1410,0.25177304964539,0.122695035460993,0.625531914893617
"761","2005-07-29",349,189,874,1412,0.247167138810198,0.13385269121813,0.618980169971671
"762","2005-08-05",356,196,884,1436,0.247910863509749,0.136490250696379,0.615598885793872
"763","2005-08-12",347,187,895,1429,0.242827151854444,0.130860741777467,0.62631210636809
"764","2005-08-19",356,190,887,1433,0.248429867411026,0.132588974180042,0.618981158408932
"765","2005-08-26",360,193,891,1444,0.249307479224377,0.133656509695291,0.617036011080332
"766","2005-09-02",361,191,895,1447,0.249481686247408,0.131997235659986,0.618521078092605
"767","2005-09-09",343,193,905,1441,0.238029146426093,0.133934767522554,0.628036086051353
"768","2005-09-16",350,191,895,1436,0.243732590529248,0.133008356545961,0.623259052924791
"769","2005-09-23",348,199,904,1451,0.239834596829773,0.137146795313577,0.623018607856651
"770","2005-09-30",341,214,928,1483,0.22993931220499,0.144302090357384,0.625758597437626
"771","2005-10-07",340,215,926,1481,0.229574611748818,0.145172180958812,0.62525320729237
"772","2005-10-14",341,210,931,1482,0.230094466936572,0.1417004048583,0.628205128205128
"773","2005-10-21",350,205,919,1474,0.237449118046133,0.139077340569878,0.623473541383989
"774","2005-10-28",346,202,932,1480,0.233783783783784,0.136486486486486,0.62972972972973
"775","2005-11-04",355,201,940,1496,0.237299465240642,0.134358288770053,0.628342245989305
"776","2005-11-11",340,208,931,1479,0.229885057471264,0.140635564570656,0.62947937795808
"777","2005-11-18",348,211,919,1478,0.235453315290934,0.14276048714479,0.621786197564276
"778","2005-11-23",361,216,914,1491,0.242119382964453,0.144869215291751,0.613011401743796
"779","2005-12-02",359,216,885,1460,0.245890410958904,0.147945205479452,0.606164383561644
"780","2005-12-09",365,219,899,1483,0.246122724207687,0.147673634524612,0.606203641267701
"781","2005-12-16",352,221,890,1463,0.240601503759399,0.151059466848941,0.608339029391661
"782","2005-12-22",351,221,903,1475,0.237966101694915,0.149830508474576,0.612203389830508
"783","2005-12-30",352,222,897,1471,0.239292997960571,0.150917743031951,0.609789259007478
"784","2006-01-06",356,232,876,1464,0.243169398907104,0.158469945355191,0.598360655737705
"785","2006-01-13",361,239,867,1467,0.246080436264485,0.16291751874574,0.591002044989775
"786","2006-01-20",362,234,876,1472,0.245923913043478,0.158967391304348,0.595108695652174
"787","2006-01-27",368,233,886,1487,0.247478143913921,0.156691324815064,0.595830531271015
"788","2006-02-03",367,251,895,1513,0.24256444150694,0.165895571711831,0.591539986781229
"789","2006-02-10",374,243,915,1532,0.244125326370757,0.158616187989556,0.597258485639687
"790","2006-02-17",363,255,927,1545,0.23495145631068,0.16504854368932,0.6
"791","2006-02-24",367,250,926,1543,0.237848347375243,0.16202203499676,0.600129617627997
"792","2006-03-03",364,245,922,1531,0.237753102547355,0.160026126714566,0.60222077073808
"793","2006-03-10",359,246,927,1532,0.234334203655352,0.160574412532637,0.60509138381201
"794","2006-03-17",357,251,938,1546,0.230918499353169,0.16235446313066,0.606727037516171
"795","2006-03-24",363,250,958,1571,0.231063017186505,0.159134309357097,0.609802673456397
"796","2006-03-31",363,257,956,1576,0.230329949238579,0.163071065989848,0.606598984771574
"797","2006-04-07",373,259,947,1579,0.236225459151362,0.164027865737809,0.59974667511083
"798","2006-04-13",381,259,970,1610,0.236645962732919,0.160869565217391,0.602484472049689
"799","2006-04-21",381,252,958,1591,0.239472030169705,0.158390949088624,0.602137020741672
"800","2006-04-28",397,259,952,1608,0.246890547263682,0.161069651741294,0.592039800995025
"801","2006-05-05",405,266,954,1625,0.249230769230769,0.163692307692308,0.587076923076923
"802","2006-05-12",399,273,955,1627,0.245236631837738,0.16779348494161,0.586969883220652
"803","2006-05-19",397,274,968,1639,0.24222086638194,0.167175106772422,0.590604026845638
"804","2006-05-26",397,281,971,1649,0.240751970891449,0.170406306852638,0.588841722255913
"805","2006-06-02",395,293,969,1657,0.23838261919131,0.176825588412794,0.584791792395896
"806","2006-06-09",386,283,992,1661,0.232390126429862,0.170379289584588,0.597230583985551
"807","2006-06-16",400,279,993,1672,0.239234449760766,0.166866028708134,0.5938995215311
"808","2006-06-23",386,288,995,1669,0.231276213301378,0.1725584182145,0.596165368484122
"809","2006-06-30",401,287,978,1666,0.240696278511405,0.172268907563025,0.58703481392557
"810","2006-07-07",407,277,975,1659,0.245328511151296,0.166968053044002,0.587703435804702
"811","2006-07-14",383,281,1004,1668,0.229616306954436,0.168465227817746,0.601918465227818
"812","2006-07-21",383,287,1013,1683,0.22756981580511,0.170528817587641,0.601901366607249
"813","2006-07-28",394,299,1021,1714,0.229871645274212,0.174445740956826,0.595682613768961
"814","2006-08-04",395,301,1009,1705,0.231671554252199,0.176539589442815,0.591788856304985
"815","2006-08-11",387,301,1040,1728,0.223958333333333,0.174189814814815,0.601851851851852
"816","2006-08-18",395,303,1064,1762,0.224177071509648,0.171963677639047,0.603859250851305
"817","2006-08-25",394,310,1052,1756,0.224373576309795,0.176537585421412,0.599088838268793
"818","2006-09-01",388,316,1028,1732,0.224018475750577,0.182448036951501,0.593533487297922
"819","2006-09-08",402,306,1020,1728,0.232638888888889,0.177083333333333,0.590277777777778
"820","2006-09-15",405,305,1027,1737,0.233160621761658,0.175590097869891,0.591249280368451
"821","2006-09-22",411,310,1033,1754,0.234321550741163,0.176738882554162,0.588939566704675
"822","2006-09-29",414,310,1020,1744,0.237385321100917,0.177752293577982,0.584862385321101
"823","2006-10-06",407,311,1006,1724,0.236078886310905,0.180394431554524,0.583526682134571
"824","2006-10-13",403,322,1003,1728,0.233217592592593,0.186342592592593,0.580439814814815
"825","2006-10-20",393,323,1023,1739,0.225991949396205,0.185738930419781,0.588269120184014
"826","2006-10-27",387,324,1033,1744,0.221903669724771,0.185779816513761,0.592316513761468
"827","2006-11-03",385,316,1038,1739,0.221391604370328,0.181713628522139,0.596894767107533
"828","2006-11-10",374,307,1012,1693,0.220909627879504,0.181334908446545,0.597755463673952
"829","2006-11-17",374,306,1016,1696,0.220518867924528,0.180424528301887,0.599056603773585
"830","2006-11-22",380,302,1015,1697,0.223924572775486,0.17796110783736,0.598114319387154
"831","2006-12-01",374,315,1028,1717,0.217821782178218,0.183459522422831,0.598718695398952
"832","2006-12-08",384,327,1013,1724,0.222737819025522,0.189675174013921,0.587587006960557
"833","2006-12-15",374,329,1013,1716,0.217948717948718,0.191724941724942,0.59032634032634
"834","2006-12-22",385,330,1008,1723,0.22344747533372,0.191526407428903,0.585026117237377
"835","2006-12-29",382,337,991,1710,0.223391812865497,0.197076023391813,0.57953216374269
"836","2007-01-05",370,335,990,1695,0.218289085545723,0.1976401179941,0.584070796460177
"837","2007-01-12",385,340,992,1717,0.22422830518346,0.198019801980198,0.577751892836343
"838","2007-01-19",387,339,1019,1745,0.221776504297994,0.194269340974212,0.583954154727794
"839","2007-01-26",361,325,1013,1699,0.212477928193055,0.191288993525603,0.596233078281342
"840","2007-02-02",365,345,1004,1714,0.212952158693116,0.201283547257876,0.585764294049008
"841","2007-02-09",361,346,1024,1731,0.208549971114962,0.199884459849798,0.59156556903524
"842","2007-02-16",369,345,1032,1746,0.211340206185567,0.197594501718213,0.59106529209622
"843","2007-02-23",379,349,1026,1754,0.216077537058153,0.198973774230331,0.584948688711517
"844","2007-03-02",392,346,1014,1752,0.223744292237443,0.197488584474886,0.578767123287671
"845","2007-03-09",400,343,1014,1757,0.22766078542971,0.195219123505976,0.577120091064314
"846","2007-03-16",384,336,1020,1740,0.220689655172414,0.193103448275862,0.586206896551724
"847","2007-03-23",394,341,1010,1745,0.225787965616046,0.19541547277937,0.578796561604585
"848","2007-03-30",407,346,996,1749,0.232704402515723,0.197827329902802,0.569468267581475
"849","2007-04-06",404,346,976,1726,0.234067207415991,0.200463499420626,0.565469293163384
"850","2007-04-13",407,354,997,1758,0.231513083048919,0.201365187713311,0.56712172923777
"851","2007-04-20",404,361,1004,1769,0.228377614471453,0.204070096099491,0.567552289429056
"852","2007-04-27",382,358,1007,1747,0.218660560961649,0.204922724670864,0.576416714367487
"853","2007-05-04",374,371,1002,1747,0.214081282198054,0.212364052661706,0.57355466514024
"854","2007-05-11",380,372,988,1740,0.218390804597701,0.213793103448276,0.567816091954023
"855","2007-05-18",372,377,995,1744,0.213302752293578,0.216169724770642,0.57052752293578
"856","2007-05-25",382,377,1001,1760,0.217045454545455,0.214204545454545,0.56875
"857","2007-06-01",383,383,1008,1774,0.215896279594138,0.215896279594138,0.568207440811725
"858","2007-06-08",387,380,993,1760,0.219886363636364,0.215909090909091,0.564204545454546
"859","2007-06-15",395,374,1004,1773,0.222786238014664,0.210941906373378,0.566271855611957
"860","2007-06-22",416,370,985,1771,0.234895539243365,0.208921513269339,0.556182947487295
"861","2007-06-29",404,377,994,1775,0.227605633802817,0.212394366197183,0.56
"862","2007-07-06",399,385,968,1752,0.227739726027397,0.219748858447489,0.552511415525114
"863","2007-07-13",396,396,999,1791,0.221105527638191,0.221105527638191,0.557788944723618
"864","2007-07-20",397,400,993,1790,0.221787709497207,0.223463687150838,0.554748603351955
"865","2007-07-27",385,410,980,1775,0.216901408450704,0.230985915492958,0.552112676056338
"866","2007-08-03",380,428,973,1781,0.21336327905671,0.240314430095452,0.546322290847838
"867","2007-08-10",378,428,992,1798,0.210233592880979,0.238042269187987,0.551724137931034
"868","2007-08-17",387,424,984,1795,0.215598885793872,0.236211699164345,0.548189415041783
"869","2007-08-24",381,435,1000,1816,0.209801762114537,0.239537444933921,0.550660792951542
"870","2007-08-31",391,433,1005,1829,0.213778020776381,0.236741388737015,0.549480590486605
"871","2007-09-07",374,435,1005,1814,0.206174200661522,0.239801543550165,0.554024255788313
"872","2007-09-14",390,425,972,1787,0.218242865137101,0.237828763290431,0.543928371572468
"873","2007-09-21",361,435,973,1769,0.204070096099491,0.245901639344262,0.550028264556247
"874","2007-09-28",350,438,972,1760,0.198863636363636,0.248863636363636,0.552272727272727
"875","2007-10-05",341,428,986,1755,0.194301994301994,0.243874643874644,0.561823361823362
"876","2007-10-12",338,428,1001,1767,0.191284663271081,0.242218449349179,0.56649688737974
"877","2007-10-19",336,420,1008,1764,0.19047619047619,0.238095238095238,0.571428571428572
"878","2007-10-26",334,433,993,1760,0.189772727272727,0.246022727272727,0.564204545454546
"879","2007-11-02",336,436,1023,1795,0.187186629526462,0.242896935933148,0.56991643454039
"880","2007-11-09",345,438,1018,1801,0.191560244308717,0.243198223209328,0.565241532481955
"881","2007-11-16",346,435,1016,1797,0.192543127434613,0.242070116861436,0.565386755703951
"882","2007-11-21",346,456,1021,1823,0.189797037849698,0.250137136588042,0.56006582556226
"883","2007-11-30",345,435,993,1773,0.194585448392555,0.245346869712352,0.560067681895093
"884","2007-12-07",361,456,1011,1828,0.197483588621444,0.24945295404814,0.553063457330416
"885","2007-12-14",372,457,995,1824,0.203947368421053,0.250548245614035,0.545504385964912
"886","2007-12-21",371,461,977,1809,0.205085682697623,0.254836926478718,0.540077390823659
"887","2007-12-28",364,443,974,1781,0.204379562043796,0.248736664795059,0.546883773161145
"888","2008-01-04",356,447,971,1774,0.200676437429538,0.251972942502818,0.547350620067644
"889","2008-01-11",359,446,939,1744,0.205848623853211,0.255733944954128,0.538417431192661
"890","2008-01-18",359,448,925,1732,0.207274826789838,0.258660508083141,0.534064665127021
"891","2008-01-25",353,446,948,1747,0.202060675443618,0.255294791070406,0.542644533485976
"892","2008-02-01",371,459,933,1763,0.210436755530346,0.260351673284175,0.529211571185479
"893","2008-02-08",368,459,928,1755,0.20968660968661,0.261538461538462,0.528774928774929
"894","2008-02-15",369,453,951,1773,0.208121827411168,0.255499153976311,0.536379018612521
"895","2008-02-22",366,464,941,1771,0.206662902315076,0.261998870694523,0.531338226990401
"896","2008-02-29",356,461,946,1763,0.201928530913216,0.261486103233125,0.536585365853659
"897","2008-03-07",354,487,961,1802,0.196448390677026,0.270255271920089,0.533296337402886
"898","2008-03-14",351,482,959,1792,0.195870535714286,0.268973214285714,0.53515625
"899","2008-03-21",335,487,962,1784,0.187780269058296,0.272982062780269,0.539237668161435
"900","2008-03-28",350,482,976,1808,0.19358407079646,0.266592920353982,0.539823008849557
"901","2008-04-04",361,481,988,1830,0.197267759562842,0.262841530054645,0.539890710382514
"902","2008-04-11",365,480,970,1815,0.201101928374656,0.264462809917355,0.534435261707989
"903","2008-04-18",360,502,965,1827,0.197044334975369,0.274767378215654,0.528188286808976
"904","2008-04-25",374,511,957,1842,0.203040173724213,0.277415852334419,0.519543973941368
"905","2008-05-02",372,515,952,1839,0.202283849918434,0.280043501903208,0.517672648178358
"906","2008-05-09",374,513,959,1846,0.202600216684724,0.277898158179848,0.519501625135428
"907","2008-05-16",376,528,958,1862,0.201933404940924,0.283566058002148,0.514500537056928
"908","2008-05-23",385,544,960,1889,0.203811540497618,0.287983059820011,0.508205399682372
"909","2008-05-30",388,533,956,1877,0.20671283963772,0.283963771976558,0.509323388385722
"910","2008-06-06",370,548,968,1886,0.196182396606575,0.290562036055143,0.513255567338282
"911","2008-06-13",380,547,974,1901,0.199894792214624,0.287743293003682,0.512361914781694
"912","2008-06-20",382,544,980,1906,0.200419727177335,0.285414480587618,0.514165792235047
"913","2008-06-27",380,564,969,1913,0.198640878201777,0.294824882383691,0.506534239414532
"914","2008-07-04",387,555,979,1921,0.201457574180115,0.288912024986986,0.5096304008329
"915","2008-07-11",386,560,976,1922,0.200832466181061,0.291363163371488,0.507804370447451
"916","2008-07-18",384,568,976,1928,0.199170124481328,0.294605809128631,0.506224066390041
"917","2008-07-25",380,587,990,1957,0.194174757281553,0.299948901379663,0.505876341338784
"918","2008-08-01",377,587,987,1951,0.193234238851871,0.300871348026653,0.505894413121476
"919","2008-08-08",362,594,1011,1967,0.18403660396543,0.301982714794103,0.513980681240468
"920","2008-08-15",376,600,1014,1990,0.18894472361809,0.301507537688442,0.509547738693467
"921","2008-08-22",389,603,1006,1998,0.194694694694695,0.301801801801802,0.503503503503503
"922","2008-08-29",388,626,1017,2031,0.191038897095027,0.30822255046775,0.500738552437223
"923","2008-09-05",391,624,998,2013,0.194237456532539,0.309985096870343,0.495777446597119
"924","2008-09-12",398,638,995,2031,0.195962580009847,0.314130969965534,0.489906450024618
"925","2008-09-19",404,627,987,2018,0.200198216055501,0.310703666997027,0.489098116947473
"926","2008-09-26",382,636,977,1995,0.191478696741855,0.318796992481203,0.489724310776942
"927","2008-10-03",380,632,967,1979,0.192016169782719,0.319353208691258,0.488630621526023
"928","2008-10-10",372,626,992,1990,0.186934673366834,0.314572864321608,0.498492462311558
"929","2008-10-17",384,624,968,1976,0.194331983805668,0.315789473684211,0.489878542510121
"930","2008-10-24",381,643,940,1964,0.193991853360489,0.327393075356415,0.478615071283096
"931","2008-10-31",381,650,940,1971,0.193302891933029,0.329781836631152,0.476915271435819
"932","2008-11-07",393,644,955,1992,0.197289156626506,0.323293172690763,0.479417670682731
"933","2008-11-14",389,624,928,1941,0.200412158681092,0.321483771251932,0.478104070066976
"934","2008-11-21",378,636,927,1941,0.194744976816074,0.327666151468315,0.477588871715611
"935","2008-11-26",370,620,876,1866,0.198285101822079,0.332261521972133,0.469453376205788
"936","2008-12-05",366,625,861,1852,0.197624190064795,0.337473002159827,0.464902807775378
"937","2008-12-12",349,618,823,1790,0.194972067039106,0.345251396648045,0.459776536312849
"938","2008-12-19",341,610,813,1764,0.193310657596372,0.345804988662132,0.460884353741497
"939","2008-12-26",325,587,809,1721,0.188843695525857,0.341080766995933,0.47007553747821
"940","2009-01-02",311,560,752,1623,0.191620455945779,0.345040049291436,0.463339494762785
"941","2009-01-09",315,552,722,1589,0.198237885462555,0.347388294524858,0.454373820012587
"942","2009-01-16",323,548,697,1568,0.205994897959184,0.349489795918367,0.444515306122449
"943","2009-01-23",290,558,667,1515,0.191419141914191,0.368316831683168,0.44026402640264
"944","2009-01-30",295,548,629,1472,0.200407608695652,0.372282608695652,0.427309782608696
"945","2009-02-06",281,518,600,1399,0.200857755539671,0.370264474624732,0.428877769835597
"946","2009-02-13",259,497,583,1339,0.193427931292009,0.371172516803585,0.435399551904406
"947","2009-02-20",244,475,581,1300,0.187692307692308,0.365384615384615,0.446923076923077
"948","2009-02-27",238,454,551,1243,0.19147224456959,0.365245374094932,0.443282381335479
"949","2009-03-06",237,445,488,1170,0.202564102564103,0.38034188034188,0.417094017094017
"950","2009-03-13",226,432,468,1126,0.200710479573712,0.383658969804618,0.41563055062167
"951","2009-03-20",207,436,442,1085,0.190783410138249,0.40184331797235,0.407373271889401
"952","2009-03-27",215,416,408,1039,0.206929740134745,0.400384985563041,0.392685274302214
"953","2009-04-03",212,409,422,1043,0.203259827420901,0.392138063279003,0.404602109300096
"954","2009-04-09",191,410,404,1005,0.190049751243781,0.407960199004975,0.401990049751244
"955","2009-04-17",186,399,390,975,0.190769230769231,0.409230769230769,0.4
"956","2009-04-24",172,385,398,955,0.180104712041885,0.403141361256544,0.416753926701571
"957","2009-05-01",169,385,391,945,0.178835978835979,0.407407407407407,0.413756613756614
"958","2009-05-08",164,380,384,928,0.176724137931035,0.40948275862069,0.413793103448276
"959","2009-05-15",160,379,379,918,0.174291938997821,0.412854030501089,0.412854030501089
"960","2009-05-22",163,375,362,900,0.181111111111111,0.416666666666667,0.402222222222222
"961","2009-05-29",164,376,359,899,0.182424916573971,0.418242491657397,0.399332591768632
"962","2009-06-05",170,372,345,887,0.191657271702368,0.419391206313416,0.388951521984217
"963","2009-06-12",164,381,331,876,0.187214611872146,0.434931506849315,0.377853881278539
"964","2009-06-19",174,391,334,899,0.193548387096774,0.434927697441602,0.371523915461624
"965","2009-06-26",171,390,356,917,0.186477644492912,0.425299890948746,0.388222464558342
"966","2009-07-02",161,396,371,928,0.173491379310345,0.426724137931034,0.399784482758621
"967","2009-07-10",165,390,361,916,0.180131004366812,0.425764192139738,0.39410480349345
"968","2009-07-17",176,399,345,920,0.191304347826087,0.433695652173913,0.375
"969","2009-07-24",183,408,352,943,0.19406150583245,0.432661717921527,0.373276776246023
"970","2009-07-31",180,413,355,948,0.189873417721519,0.435654008438819,0.374472573839662
"971","2009-08-07",172,422,372,966,0.178053830227743,0.436853002070393,0.385093167701863
"972","2009-08-14",174,421,373,968,0.179752066115702,0.434917355371901,0.385330578512397
"973","2009-08-21",171,428,386,985,0.173604060913706,0.434517766497462,0.391878172588833
"974","2009-08-28",177,429,393,999,0.177177177177177,0.429429429429429,0.393393393393393
"975","2009-09-04",189,426,394,1009,0.187314172447968,0.422200198216056,0.390485629335976
"976","2009-09-11",184,430,385,999,0.184184184184184,0.43043043043043,0.385385385385385
"977","2009-09-18",195,432,383,1010,0.193069306930693,0.427722772277228,0.379207920792079
"978","2009-09-25",194,442,381,1017,0.190757128810226,0.434611602753196,0.374631268436578
"979","2009-10-02",184,444,396,1024,0.1796875,0.43359375,0.38671875
"980","2009-10-09",184,463,394,1041,0.176753121998079,0.4447646493756,0.378482228626321
"981","2009-10-16",181,465,394,1040,0.174038461538462,0.447115384615385,0.378846153846154
"982","2009-10-23",179,472,397,1048,0.170801526717557,0.450381679389313,0.37881679389313
"983","2009-10-30",180,497,392,1069,0.168381665107577,0.464920486435921,0.366697848456501
"984","2009-11-06",186,507,385,1078,0.172541743970315,0.470315398886827,0.357142857142857
"985","2009-11-13",194,512,395,1101,0.176203451407811,0.465031789282471,0.358764759309718
"986","2009-11-20",189,531,393,1113,0.169811320754717,0.477088948787062,0.353099730458221
"987","2009-11-25",188,539,410,1137,0.165347405452946,0.4740545294635,0.360598065083553
"988","2009-12-04",185,547,409,1141,0.162138475021911,0.479404031551271,0.358457493426819
"989","2009-12-11",191,558,412,1161,0.164513350559862,0.48062015503876,0.354866494401378
"990","2009-12-18",202,572,419,1193,0.169321039396479,0.479463537300922,0.351215423302598
"991","2009-12-23",199,564,415,1178,0.16893039049236,0.478777589134126,0.352292020373514
"992","2009-12-31",200,571,418,1189,0.168208578637511,0.480235492010093,0.351555929352397
"993","2010-01-08",199,583,438,1220,0.163114754098361,0.477868852459016,0.359016393442623
"994","2010-01-15",204,611,433,1248,0.163461538461538,0.489583333333333,0.346955128205128
"995","2010-01-22",218,627,437,1282,0.170046801872075,0.489079563182527,0.340873634945398
"996","2010-01-29",226,647,444,1317,0.171602126044039,0.491268033409264,0.337129840546697
"997","2010-02-05",230,659,446,1335,0.172284644194757,0.493632958801498,0.334082397003745
"998","2010-02-12",232,663,451,1346,0.172362555720654,0.492570579494799,0.335066864784547
"999","2010-02-19",228,658,459,1345,0.169516728624535,0.489219330855019,0.341263940520446
"1000","2010-02-26",235,679,459,1373,0.17115804806992,0.494537509104152,0.334304442825929
"1001","2010-03-05",230,695,471,1396,0.164756446991404,0.49785100286533,0.337392550143267
"1002","2010-03-12",216,702,489,1407,0.153518123667377,0.498933901918977,0.347547974413646
"1003","2010-03-19",225,711,491,1427,0.157673440784863,0.498248072880168,0.344078486334968
"1004","2010-03-26",227,725,492,1444,0.157202216066482,0.50207756232687,0.340720221606648
"1005","2010-04-01",222,735,508,1465,0.151535836177474,0.501706484641638,0.346757679180887
"1006","2010-04-09",225,749,502,1476,0.152439024390244,0.507452574525745,0.340108401084011
"1007","2010-04-16",232,754,505,1491,0.155600268276325,0.505700871898055,0.33869885982562
"1008","2010-04-23",232,753,497,1482,0.156545209176788,0.508097165991903,0.335357624831309
"1009","2010-04-30",229,765,489,1483,0.154416722859069,0.515846257585974,0.329737019554956
"1010","2010-05-07",230,764,498,1492,0.154155495978552,0.512064343163539,0.333780160857909
"1011","2010-05-14",228,776,502,1506,0.151394422310757,0.51527224435591,0.333333333333333
"1012","2010-05-21",232,782,504,1518,0.152832674571805,0.515151515151515,0.33201581027668
"1013","2010-05-28",226,795,514,1535,0.147231270358306,0.517915309446254,0.33485342019544
"1014","2010-06-04",226,798,482,1506,0.150066401062417,0.529880478087649,0.320053120849934
"1015","2010-06-11",230,819,478,1527,0.150622134905043,0.536345776031434,0.313032089063523
"1016","2010-06-18",233,827,479,1539,0.151397011046134,0.537361923326836,0.311241065627031
"1017","2010-06-25",236,833,483,1552,0.152061855670103,0.536726804123711,0.311211340206186
"1018","2010-07-02",230,849,478,1557,0.14771997430957,0.545279383429672,0.307000642260758
"1019","2010-07-09",226,863,478,1567,0.144224633056796,0.550733886407147,0.305041480536056
"1020","2010-07-16",214,859,498,1571,0.136218968809675,0.546785486950987,0.316995544239338
"1021","2010-07-23",218,858,509,1585,0.137539432176656,0.541324921135647,0.321135646687697
"1022","2010-07-30",220,853,513,1586,0.138713745271122,0.537831021437579,0.323455233291299
"1023","2010-08-06",221,878,506,1605,0.137694704049844,0.547040498442368,0.315264797507788
"1024","2010-08-13",222,885,533,1640,0.135365853658537,0.539634146341463,0.325
"1025","2010-08-20",217,895,539,1651,0.131435493640218,0.542095699576015,0.326468806783767
"1026","2010-08-27",225,904,527,1656,0.135869565217391,0.545893719806763,0.318236714975845
"1027","2010-09-03",222,903,528,1653,0.134301270417423,0.546279491833031,0.319419237749546
"1028","2010-09-10",231,911,512,1654,0.139661426844015,0.550785973397823,0.309552599758162
"1029","2010-09-17",222,912,527,1661,0.133654425045154,0.549066827212523,0.317278747742324
"1030","2010-09-24",213,912,525,1650,0.129090909090909,0.552727272727273,0.318181818181818
"1031","2010-10-01",220,916,523,1659,0.132610006027728,0.552139843279084,0.315250150693189
"1032","2010-10-08",213,929,529,1671,0.127468581687612,0.555954518252543,0.316576900059844
"1033","2010-10-15",206,926,538,1670,0.123353293413174,0.554491017964072,0.322155688622755
"1034","2010-10-22",223,907,539,1669,0.133612941881366,0.543439185140803,0.322947872977831
"1035","2010-10-29",220,919,533,1672,0.131578947368421,0.549641148325359,0.31877990430622
"1036","2010-11-05",218,943,522,1683,0.129530600118835,0.560308972073678,0.310160427807487
"1037","2010-11-12",209,940,536,1685,0.124035608308605,0.55786350148368,0.318100890207715
"1038","2010-11-19",213,932,532,1677,0.12701252236136,0.555754323196184,0.317233154442457
"1039","2010-11-24",216,948,523,1687,0.128037937166568,0.561944279786603,0.310017783046829
"1040","2010-12-03",218,966,529,1713,0.127262113251605,0.563922942206655,0.30881494454174
"1041","2010-12-10",225,966,532,1723,0.130586186883343,0.560650029019153,0.308763784097504
"1042","2010-12-17",220,954,535,1709,0.128730251609128,0.558221181977765,0.313048566413107
"1043","2010-12-22",209,959,546,1714,0.12193698949825,0.55950991831972,0.31855309218203
"1044","2010-12-30",212,947,535,1694,0.125147579693034,0.559031877213695,0.31582054309327
"1045","2011-01-07",211,966,523,1700,0.124117647058824,0.568235294117647,0.307647058823529
"1046","2011-01-14",219,967,514,1700,0.128823529411765,0.568823529411765,0.302352941176471
"1047","2011-01-21",233,966,514,1713,0.136018680677175,0.563922942206655,0.300058377116171
"1048","2011-01-28",237,973,522,1732,0.136836027713626,0.561778290993072,0.301385681293303
"1049","2011-02-04",229,981,529,1739,0.131684876365727,0.56411730879816,0.304197814836113
"1050","2011-02-11",225,980,516,1721,0.130737943056363,0.569436374201046,0.299825682742592
"1051","2011-02-18",223,984,506,1713,0.130180969060128,0.574430823117338,0.295388207822534
"1052","2011-02-25",220,981,498,1699,0.12948793407887,0.577398469688052,0.293113596233078
"1053","2011-03-04",234,970,503,1707,0.137082601054482,0.568248388986526,0.294669009958992
"1054","2011-03-11",225,981,509,1715,0.131195335276968,0.57201166180758,0.296793002915452
"1055","2011-03-18",231,986,503,1720,0.134302325581395,0.573255813953488,0.292441860465116
"1056","2011-03-25",224,995,519,1738,0.128883774453395,0.572497123130035,0.298619102416571
"1057","2011-04-01",228,1017,531,1776,0.128378378378378,0.572635135135135,0.298986486486486
"1058","2011-04-08",230,1009,543,1782,0.129068462401796,0.5662177328844,0.304713804713805
"1059","2011-04-15",217,1003,552,1772,0.122460496613995,0.566027088036117,0.311512415349887
"1060","2011-04-21",213,1020,567,1800,0.118333333333333,0.566666666666667,0.315
"1061","2011-04-29",219,1023,576,1818,0.12046204620462,0.562706270627063,0.316831683168317
"1062","2011-05-06",225,1038,573,1836,0.122549019607843,0.565359477124183,0.312091503267974
"1063","2011-05-13",226,1041,563,1830,0.123497267759563,0.568852459016393,0.307650273224044
"1064","2011-05-20",225,1038,567,1830,0.122950819672131,0.567213114754098,0.309836065573771
"1065","2011-05-27",232,1054,561,1847,0.125609095831077,0.570655116404981,0.303735787763942
"1066","2011-06-03",230,1051,573,1854,0.124056094929881,0.56688241639698,0.309061488673139
"1067","2011-06-10",231,1065,559,1855,0.124528301886792,0.574123989218329,0.301347708894879
"1068","2011-06-17",241,1061,558,1860,0.129569892473118,0.570430107526882,0.3
"1069","2011-06-24",236,1081,565,1882,0.125398512221041,0.574388947927737,0.300212539851222
"1070","2011-07-01",243,1073,570,1886,0.128844114528102,0.568928950159067,0.302226935312831
"1071","2011-07-08",244,1073,570,1887,0.1293057763646,0.568627450980392,0.302066772655008
"1072","2011-07-15",253,1086,566,1905,0.132808398950131,0.57007874015748,0.297112860892388
"1073","2011-07-22",244,1102,570,1916,0.127348643006263,0.575156576200417,0.297494780793319
"1074","2011-07-29",246,1080,582,1908,0.128930817610063,0.566037735849057,0.30503144654088
"1075","2011-08-05",244,1099,577,1920,0.127083333333333,0.572395833333333,0.300520833333333
"1076","2011-08-12",240,1123,596,1959,0.122511485451761,0.573251659009699,0.30423685553854
"1077","2011-08-19",227,1138,609,1974,0.11499493414387,0.576494427558257,0.308510638297872
"1078","2011-08-26",228,1140,607,1975,0.115443037974684,0.577215189873418,0.307341772151899
"1079","2011-09-02",238,1136,594,1968,0.120934959349594,0.577235772357724,0.301829268292683
"1080","2011-09-09",235,1134,589,1958,0.120020429009193,0.579162410623085,0.300817160367722
"1081","2011-09-16",241,1137,607,1985,0.121410579345088,0.5727959697733,0.305793450881612
"1082","2011-09-23",242,1140,609,1991,0.121546961325967,0.572576594676042,0.305876443997991
"1083","2011-09-30",238,1135,617,1990,0.119597989949749,0.57035175879397,0.310050251256281
"1084","2011-10-07",246,1148,618,2012,0.122266401590457,0.570576540755467,0.307157057654076
"1085","2011-10-14",250,1153,620,2023,0.123578843302027,0.569945625308947,0.306475531389026
"1086","2011-10-21",241,1142,630,2013,0.119721808246398,0.567312468951813,0.312965722801788
"1087","2011-10-28",243,1155,623,2021,0.120237506185057,0.571499257793172,0.308263236021771
"1088","2011-11-04",243,1157,626,2026,0.119940769990128,0.571076011846002,0.30898321816387
"1089","2011-11-11",231,1152,633,2016,0.114583333333333,0.571428571428572,0.313988095238095
"1090","2011-11-18",213,1147,641,2001,0.106446776611694,0.573213393303348,0.320339830084958
"1091","2011-11-25",213,1155,632,2000,0.1065,0.5775,0.316
"1092","2011-12-02",217,1156,620,1993,0.108881083793276,0.580030105368791,0.311088810837933
"1093","2011-12-09",217,1151,619,1987,0.109209864116759,0.579265223955712,0.311524911927529
"1094","2011-12-16",213,1184,622,2019,0.105497771173848,0.5864289252105,0.308073303615651
"1095","2011-12-22",213,1172,623,2008,0.106075697211155,0.583665338645418,0.310258964143426
"1096","2011-12-29",215,1167,625,2007,0.107125062282013,0.581464872944694,0.311410064773293
"1097","2012-01-06",216,1160,631,2007,0.10762331838565,0.577977080219233,0.314399601395117
"1098","2012-01-13",213,1161,613,1987,0.107196779063915,0.584297936587821,0.308505284348264
"1099","2012-01-20",206,1183,619,2008,0.102589641434263,0.589143426294821,0.308266932270916
"1100","2012-01-27",217,1185,606,2008,0.108067729083665,0.590139442231076,0.301792828685259
"1101","2012-02-03",217,1174,606,1997,0.108662994491738,0.587881822734101,0.303455182774161
"1102","2012-02-10",215,1171,603,1989,0.108094519859226,0.588738059326295,0.30316742081448
"1103","2012-02-17",214,1163,617,1994,0.107321965897693,0.583249749247743,0.309428284854564
"1104","2012-02-24",210,1165,606,1981,0.106007067137809,0.588086824835942,0.305906108026249
"1105","2012-03-02",215,1170,604,1989,0.108094519859226,0.588235294117647,0.303670186023127
"1106","2012-03-09",212,1164,597,1973,0.107450582868728,0.589964521033958,0.302584896097314
"1107","2012-03-16",228,1180,576,1984,0.11491935483871,0.594758064516129,0.290322580645161
"1108","2012-03-23",231,1174,563,1968,0.117378048780488,0.596544715447154,0.286077235772358
"1109","2012-03-30",233,1180,566,1979,0.117736230419404,0.596260737746336,0.28600303183426
"1110","2012-04-05",231,1165,583,1979,0.116725618999495,0.588681152097019,0.294593228903487
"1111","2012-04-13",237,1145,568,1950,0.121538461538462,0.587179487179487,0.291282051282051
"1112","2012-04-20",246,1155,571,1972,0.12474645030426,0.585699797160243,0.289553752535497
"1113","2012-04-27",243,1139,563,1945,0.124935732647815,0.58560411311054,0.289460154241645
"1114","2012-05-04",234,1158,573,1965,0.119083969465649,0.589312977099237,0.291603053435115
"1115","2012-05-11",228,1187,559,1974,0.115501519756839,0.601317122593718,0.283181357649443
"1116","2012-05-18",227,1193,566,1986,0.114300100704935,0.600704934541793,0.284994964753273
"1117","2012-05-25",222,1191,570,1983,0.111951588502269,0.600605143721634,0.287443267776097
"1118","2012-06-01",217,1183,580,1980,0.10959595959596,0.597474747474747,0.292929292929293
"1119","2012-06-08",235,1177,572,1984,0.118447580645161,0.593245967741935,0.288306451612903
"1120","2012-06-15",233,1162,576,1971,0.118214104515474,0.589548452562151,0.292237442922374
"1121","2012-06-22",233,1165,568,1966,0.118514750762971,0.592573753814853,0.288911495422177
"1122","2012-06-29",235,1171,553,1959,0.119959162838183,0.597753956100051,0.282286881061766
"1123","2012-07-06",242,1174,549,1965,0.123155216284987,0.597455470737913,0.279389312977099
"1124","2012-07-13",232,1166,555,1953,0.11879160266257,0.597030209933436,0.284178187403994
"1125","2012-07-20",230,1164,541,1935,0.118863049095607,0.601550387596899,0.279586563307494
"1126","2012-07-27",240,1151,533,1924,0.124740124740125,0.598232848232848,0.277027027027027
"1127","2012-08-03",228,1155,547,1930,0.118134715025907,0.598445595854922,0.283419689119171
"1128","2012-08-10",227,1161,543,1931,0.117555670636976,0.601242879337131,0.281201450025893
"1129","2012-08-17",229,1153,532,1914,0.119644723092999,0.602403343782654,0.277951933124347
"1130","2012-08-24",220,1159,519,1898,0.115911485774499,0.610642781875659,0.273445732349842
"1131","2012-08-31",219,1149,526,1894,0.115628299894403,0.606652587117212,0.277719112988384
"1132","2012-09-07",214,1135,515,1864,0.11480686695279,0.608905579399142,0.276287553648069
"1133","2012-09-14",207,1133,524,1864,0.111051502145923,0.607832618025751,0.281115879828326
"1134","2012-09-21",202,1149,508,1859,0.108660570199032,0.618074233458849,0.273265196342119
"1135","2012-09-28",192,1142,514,1848,0.103896103896104,0.617965367965368,0.278138528138528
"1136","2012-10-05",194,1132,511,1837,0.105606967882417,0.616222101252041,0.278170930865542
"1137","2012-10-12",194,1112,529,1835,0.105722070844687,0.605994550408719,0.288283378746594
"1138","2012-10-19",200,1114,525,1839,0.108754758020663,0.605764002175095,0.285481239804241
"1139","2012-10-26",209,1105,512,1826,0.114457831325301,0.605147864184009,0.28039430449069
"1140","2012-11-02",195,1105,500,1800,0.108333333333333,0.613888888888889,0.277777777777778
"1141","2012-11-09",194,1104,508,1806,0.107419712070875,0.611295681063123,0.281284606866002
"1142","2012-11-16",194,1105,510,1809,0.107241569928137,0.610834715312327,0.281923714759536
"1143","2012-11-21",194,1114,509,1817,0.106769400110072,0.613098514034122,0.280132085855806
"1144","2012-11-30",193,1110,508,1811,0.10657095527333,0.612921038100497,0.280508006626173
"1145","2012-12-07",191,1103,506,1800,0.106111111111111,0.612777777777778,0.281111111111111
"1146","2012-12-14",190,1105,504,1799,0.105614230127849,0.614230127848805,0.280155642023346
"1147","2012-12-21",182,1105,487,1774,0.102593010146561,0.622886133032695,0.274520856820744
"1148","2012-12-28",175,1111,477,1763,0.0992626205331821,0.630175836642087,0.270561542824731
"1149","2013-01-04",170,1112,480,1762,0.0964812712826334,0.631101021566402,0.272417707150965
"1150","2013-01-11",182,1119,460,1761,0.103350369108461,0.635434412265758,0.261215218625781
"1151","2013-01-18",180,1127,442,1749,0.102915951972556,0.644368210405946,0.252715837621498
"1152","2013-01-25",181,1127,445,1753,0.103251568739304,0.642897889332573,0.253850541928123
"1153","2013-02-01",183,1136,445,1764,0.103741496598639,0.643990929705215,0.252267573696145
"1154","2013-02-08",185,1143,431,1759,0.105173393973849,0.649801023308698,0.245025582717453
"1155","2013-02-15",194,1139,429,1762,0.110102156640182,0.646424517593644,0.243473325766175
"1156","2013-02-22",197,1140,424,1761,0.111868256672345,0.647359454855196,0.240772288472459
"1157","2013-03-01",185,1141,431,1757,0.105293113261241,0.649402390438247,0.245304496300512
"1158","2013-03-08",195,1130,427,1752,0.111301369863014,0.644977168949772,0.243721461187215
"1159","2013-03-15",209,1131,436,1776,0.11768018018018,0.636824324324324,0.245495495495496
"1160","2013-03-22",214,1100,432,1746,0.122565864833906,0.630011454753723,0.247422680412371
"1161","2013-03-28",206,1099,443,1748,0.117848970251716,0.628718535469108,0.253432494279176
"1162","2013-04-05",203,1084,451,1738,0.116800920598389,0.623705408515535,0.259493670886076
"1163","2013-04-12",206,1102,463,1771,0.116318464144551,0.622247317899492,0.261434217955957
"1164","2013-04-19",200,1097,461,1758,0.113765642775882,0.624004550625711,0.262229806598407
"1165","2013-04-26",199,1084,471,1754,0.11345496009122,0.618015963511973,0.268529076396807
"1166","2013-05-03",197,1092,475,1764,0.111678004535147,0.619047619047619,0.269274376417234
"1167","2013-05-10",198,1099,472,1769,0.111927642736009,0.621254946297343,0.266817410966648
"1168","2013-05-17",211,1096,462,1769,0.11927642736009,0.619559072922555,0.261164499717354
"1169","2013-05-24",218,1087,457,1762,0.12372304199773,0.616912599318956,0.259364358683314
"1170","2013-05-31",232,1089,450,1771,0.130999435347261,0.614906832298137,0.254093732354602
"1171","2013-06-07",238,1088,439,1765,0.134844192634561,0.61643059490085,0.248725212464589
"1172","2013-06-14",244,1086,441,1771,0.137775268210051,0.613212874082439,0.24901185770751
"1173","2013-06-21",242,1079,438,1759,0.13757816941444,0.613416714042069,0.249005116543491
"1174","2013-06-28",240,1067,441,1748,0.137299771167048,0.610411899313501,0.252288329519451
"1175","2013-07-03",255,1068,434,1757,0.14513375071144,0.607854297097325,0.247011952191235
"1176","2013-07-12",269,1058,432,1759,0.152927799886299,0.601478112563957,0.245594087549744
"1177","2013-07-19",280,1058,432,1770,0.15819209039548,0.59774011299435,0.24406779661017
"1178","2013-07-26",287,1067,422,1776,0.161599099099099,0.600788288288288,0.237612612612613
"1179","2013-08-02",277,1073,432,1782,0.155443322109989,0.602132435465769,0.242424242424242
"1180","2013-08-09",266,1065,447,1778,0.149606299212598,0.598987626546682,0.25140607424072
"1181","2013-08-16",269,1077,445,1791,0.150195421552205,0.601340033500838,0.248464544946957
"1182","2013-08-23",256,1075,445,1776,0.144144144144144,0.605292792792793,0.250563063063063
"1183","2013-08-30",248,1078,450,1776,0.13963963963964,0.606981981981982,0.253378378378378
"1184","2013-09-06",250,1075,442,1767,0.141482739105829,0.608375778155065,0.250141482739106
"1185","2013-09-13",248,1076,444,1768,0.14027149321267,0.608597285067873,0.251131221719457
"1186","2013-09-20",249,1091,421,1761,0.141396933560477,0.619534355479841,0.239068710959682
"1187","2013-09-27",242,1085,417,1744,0.138761467889908,0.622133027522936,0.239105504587156
"1188","2013-10-04",241,1099,416,1756,0.137243735763098,0.625854214123007,0.236902050113895
"1189","2013-10-11",228,1106,409,1743,0.130808950086059,0.634538152610442,0.2346528973035
"1190","2013-10-18",239,1099,401,1739,0.137435307648074,0.631972397929845,0.230592294422082
"1191","2013-10-25",249,1098,391,1738,0.143268124280783,0.631760644418872,0.224971231300345
"1192","2013-11-01",230,1104,408,1742,0.13203214695752,0.633754305396096,0.234213547646383
"1193","2013-11-08",223,1114,417,1754,0.127137970353478,0.635119726339795,0.237742303306727
"1194","2013-11-15",220,1114,428,1762,0.124858115777526,0.632236095346198,0.242905788876277
"1195","2013-11-22",216,1127,418,1761,0.122657580919932,0.639977285633163,0.237365133446905
"1196","2013-11-27",222,1127,414,1763,0.125921724333522,0.639251276233693,0.234826999432785
"1197","2013-12-06",223,1137,415,1775,0.125633802816901,0.64056338028169,0.233802816901408
"1198","2013-12-13",230,1145,407,1782,0.129068462401796,0.642536475869809,0.228395061728395
"1199","2013-12-20",223,1140,405,1768,0.126131221719457,0.644796380090498,0.229072398190045
"1200","2013-12-27",224,1146,387,1757,0.127490039840637,0.652248150256118,0.220261809903244
"1201","2014-01-03",226,1148,377,1751,0.129069103369503,0.655625356938892,0.215305539691605
"1202","2014-01-10",224,1158,372,1754,0.127708095781072,0.660205245153934,0.212086659064994
"1203","2014-01-17",219,1173,385,1777,0.123241418120428,0.660101294316263,0.216657287563309
"1204","2014-01-24",211,1170,396,1777,0.118739448508723,0.658413055711874,0.222847495779403
"1205","2014-01-31",220,1173,392,1785,0.123249299719888,0.657142857142857,0.219607843137255
"1206","2014-02-07",206,1176,389,1771,0.116318464144551,0.66403162055336,0.219649915302089
"1207","2014-02-14",201,1183,380,1764,0.113945578231293,0.670634920634921,0.215419501133787
"1208","2014-02-21",197,1182,392,1771,0.111236589497459,0.667419536984754,0.221343873517787
"1209","2014-02-28",197,1181,391,1769,0.11136235161108,0.667608818541549,0.221028829847371
"1210","2014-03-07",198,1202,392,1792,0.110491071428571,0.670758928571429,0.21875
"1211","2014-03-14",204,1212,393,1809,0.112769485903814,0.669983416252073,0.217247097844113
"1212","2014-03-21",213,1206,384,1803,0.118136439267887,0.668885191347754,0.212978369384359
"1213","2014-03-28",214,1211,384,1809,0.118297401879491,0.669430624654505,0.212271973466003
"1214","2014-04-04",201,1224,393,1818,0.110561056105611,0.673267326732673,0.216171617161716
"1215","2014-04-11",216,1224,391,1831,0.11796832332059,0.668487165483343,0.213544511196068
"1216","2014-04-17",216,1224,391,1831,0.11796832332059,0.668487165483343,0.213544511196068
"1217","2014-04-25",218,1245,398,1861,0.117141321869962,0.668995163890382,0.213863514239656
"1218","2014-05-02",211,1247,396,1854,0.113807982740022,0.67259978425027,0.213592233009709
"1219","2014-05-09",208,1243,404,1855,0.112129380053908,0.670080862533693,0.217789757412399
"1220","2014-05-16",207,1248,406,1861,0.111230521225148,0.670607200429876,0.218162278344976
"1221","2014-05-23",205,1243,409,1857,0.110393107162089,0.669359181475498,0.220247711362413
"1222","2014-05-30",212,1251,403,1866,0.113612004287245,0.670418006430868,0.215969989281886
"1223","2014-06-06",221,1250,389,1860,0.118817204301075,0.672043010752688,0.209139784946237
"1224","2014-06-13",218,1248,388,1854,0.117583603020496,0.673139158576052,0.209277238403452
"1225","2014-06-20",228,1250,380,1858,0.122712594187298,0.672766415500538,0.204520990312164
"1226","2014-06-27",229,1263,381,1873,0.122263747997864,0.674319273892152,0.203416978109984
"1227","2014-07-03",222,1268,384,1874,0.11846318036286,0.676627534685165,0.204909284951974
"1228","2014-07-11",222,1276,377,1875,0.1184,0.680533333333333,0.201066666666667
"1229","2014-07-18",217,1288,366,1871,0.115980758952432,0.688401924104757,0.195617316942811
"1230","2014-07-25",229,1293,361,1883,0.121614445034519,0.686670207116304,0.191715347849177
"1231","2014-08-01",218,1298,373,1889,0.115404976177872,0.68713605082054,0.197458973001588
"1232","2014-08-08",213,1317,378,1908,0.111635220125786,0.690251572327044,0.19811320754717
"1233","2014-08-15",216,1329,368,1913,0.112911657083116,0.694720334553058,0.192368008363826
"1234","2014-08-22",209,1321,366,1896,0.110232067510549,0.696729957805907,0.193037974683544
"1235","2014-08-29",210,1330,374,1914,0.109717868338558,0.694879832810867,0.195402298850575
"1236","2014-09-05",224,1333,368,1925,0.116363636363636,0.692467532467532,0.191168831168831
"1237","2014-09-12",217,1342,372,1931,0.112377006732263,0.694976696012429,0.192646297255308
"1238","2014-09-19",212,1341,378,1931,0.109787674779907,0.694458829621958,0.195753495598136
"1239","2014-09-26",211,1347,373,1931,0.109269808389436,0.697566027964785,0.193164163645779
"1240","2014-10-03",209,1341,372,1922,0.108740894901145,0.697710718002081,0.193548387096774
"1241","2014-10-10",207,1353,370,1930,0.107253886010363,0.701036269430052,0.191709844559585
"1242","2014-10-17",203,1353,362,1918,0.105839416058394,0.705422314911366,0.18873826903024
"1243","2014-10-24",211,1355,361,1927,0.109496626881162,0.703165542293721,0.187337830825117
"1244","2014-10-31",211,1353,365,1929,0.10938310005184,0.701399688958009,0.18921721099015
"1245","2014-11-07",203,1362,360,1925,0.105454545454545,0.707532467532468,0.187012987012987
"1246","2014-11-14",205,1369,354,1928,0.106327800829876,0.7100622406639,0.183609958506224
"1247","2014-11-21",205,1372,352,1929,0.106272680145153,0.711249351995853,0.182477967858994
"1248","2014-11-26",194,1371,352,1917,0.101199791340636,0.715179968701096,0.183620239958268
"1249","2014-12-05",198,1368,354,1920,0.103125,0.7125,0.184375
"1250","2014-12-12",196,1367,330,1893,0.103539355520338,0.722134178552562,0.1743264659271
"1251","2014-12-19",195,1356,324,1875,0.104,0.7232,0.1728
"1252","2014-12-26",181,1350,309,1840,0.0983695652173913,0.733695652173913,0.167934782608696
"1253","2015-01-02",175,1336,300,1811,0.0966316951960243,0.73771397018222,0.165654334621756
"1254","2015-01-09",161,1301,288,1750,0.092,0.743428571428572,0.164571428571429
"1255","2015-01-16",153,1253,270,1676,0.0912887828162291,0.747613365155131,0.16109785202864
"1256","2015-01-23",146,1229,258,1633,0.0894060012247398,0.75260257195346,0.1579914268218
"1257","2015-01-30",140,1168,235,1543,0.0907323395981854,0.756966947504861,0.152300712896954
"1258","2015-02-06",135,1088,233,1456,0.0927197802197802,0.747252747252747,0.160027472527473
"1259","2015-02-13",123,1025,210,1358,0.0905743740795287,0.754786450662739,0.154639175257732
"1260","2015-02-20",128,979,203,1310,0.0977099236641222,0.747328244274809,0.154961832061069
"1261","2015-02-27",127,946,194,1267,0.100236779794791,0.746645619573796,0.153117600631413
"1262","2015-03-06",120,895,177,1192,0.100671140939597,0.750838926174497,0.148489932885906
"1263","2015-03-13",110,849,166,1125,0.0977777777777778,0.754666666666667,0.147555555555556
"1264","2015-03-20",92,829,148,1069,0.0860617399438728,0.775491113189897,0.13844714686623
"1265","2015-03-27",92,812,144,1048,0.0877862595419847,0.774809160305344,0.137404580152672
"1266","2015-04-02",93,799,136,1028,0.0904669260700389,0.777237354085603,0.132295719844358
"1267","2015-04-10",90,770,128,988,0.0910931174089069,0.779352226720648,0.129554655870445
"1268","2015-04-17",91,741,122,954,0.0953878406708595,0.776729559748428,0.127882599580713
"1269","2015-04-24",91,720,121,932,0.0976394849785408,0.772532188841202,0.129828326180257
"1270","2015-05-01",93,699,113,905,0.102762430939227,0.772375690607735,0.124861878453039
"1271","2015-05-08",88,692,114,894,0.0984340044742729,0.774049217002237,0.12751677852349
"1272","2015-05-15",89,685,114,888,0.100225225225225,0.771396396396396,0.128378378378378
"1273","2015-05-22",85,683,117,885,0.096045197740113,0.771751412429379,0.132203389830508
"1274","2015-05-29",90,674,111,875,0.102857142857143,0.770285714285714,0.126857142857143
"1275","2015-06-05",96,673,99,868,0.110599078341014,0.775345622119816,0.114055299539171
"1276","2015-06-12",95,663,101,859,0.110593713620489,0.771827706635623,0.117578579743888
"1277","2015-06-19",95,662,100,857,0.110851808634772,0.772462077012835,0.116686114352392
"1278","2015-06-26",98,654,107,859,0.114086146682189,0.761350407450524,0.124563445867288
"1279","2015-07-02",97,657,108,862,0.112529002320186,0.762180974477958,0.125290023201856
"1280","2015-07-10",88,654,121,863,0.101969872537659,0.757821552723059,0.140208574739282
"1281","2015-07-17",84,650,123,857,0.0980163360560093,0.758459743290548,0.143523920653442
"1282","2015-07-24",83,662,131,876,0.0947488584474886,0.755707762557078,0.149543378995434
"1283","2015-07-31",84,664,126,874,0.0961098398169336,0.759725400457666,0.1441647597254
"1284","2015-08-07",83,672,129,884,0.0938914027149321,0.760180995475113,0.145927601809955
"1285","2015-08-14",81,676,127,884,0.0916289592760181,0.764705882352941,0.143665158371041
"1286","2015-08-21",78,677,130,885,0.088135593220339,0.764971751412429,0.146892655367232
"1287","2015-08-28",80,672,125,877,0.0912200684150513,0.766248574686431,0.142531356898518
"1288","2015-09-04",85,659,120,864,0.0983796296296296,0.762731481481482,0.138888888888889
"1289","2015-09-11",81,648,119,848,0.0955188679245283,0.764150943396226,0.140330188679245
"1290","2015-09-18",83,640,119,842,0.0985748218527316,0.760095011876485,0.141330166270784
"1291","2015-09-25",86,629,123,838,0.102625298329356,0.750596658711217,0.146778042959427
"1292","2015-10-02",83,609,117,809,0.102595797280593,0.752781211372064,0.144622991347342
"1293","2015-10-09",83,598,114,795,0.10440251572327,0.752201257861635,0.143396226415094
"1294","2015-10-16",86,591,110,787,0.109275730622618,0.750952986022872,0.139771283354511
"1295","2015-10-23",87,591,109,787,0.110546378653113,0.750952986022872,0.138500635324015
"1296","2015-10-30",86,577,112,775,0.110967741935484,0.744516129032258,0.144516129032258
"1297","2015-11-06",81,585,105,771,0.105058365758755,0.75875486381323,0.136186770428016
"1298","2015-11-13",72,587,108,767,0.0938722294654498,0.765319426336376,0.140808344198175
"1299","2015-11-20",69,581,107,757,0.0911492734478204,0.767503302509908,0.141347424042272
"1300","2015-11-25",66,569,109,744,0.0887096774193548,0.764784946236559,0.146505376344086
"1301","2015-12-04",64,569,104,737,0.0868385345997286,0.772048846675712,0.141112618724559
"1302","2015-12-11",64,554,91,709,0.0902679830747532,0.781382228490832,0.128349788434415
"1303","2015-12-18",63,559,87,709,0.0888575458392102,0.788434414668547,0.122708039492243
"1304","2015-12-23",60,554,86,700,0.0857142857142857,0.791428571428571,0.122857142857143
"1305","2015-12-31",60,549,89,698,0.0859598853868195,0.786532951289398,0.127507163323782
"1306","2016-01-08",64,519,81,664,0.0963855421686747,0.781626506024096,0.121987951807229
"1307","2016-01-15",62,511,77,650,0.0953846153846154,0.786153846153846,0.118461538461538
"1308","2016-01-22",60,500,77,637,0.0941915227629513,0.784929356357928,0.120879120879121
"1309","2016-01-29",58,487,74,619,0.0936995153473344,0.786752827140549,0.119547657512116
"1310","2016-02-05",53,458,60,571,0.0928196147110333,0.802101576182137,0.10507880910683
"1311","2016-02-12",49,433,59,541,0.0905730129390019,0.800369685767098,0.1090573012939
"1312","2016-02-19",48,416,50,514,0.0933852140077821,0.809338521400778,0.0972762645914397
"1313","2016-02-26",47,397,58,502,0.0936254980079681,0.790836653386454,0.115537848605578
"1314","2016-03-04",42,389,58,489,0.0858895705521472,0.795501022494888,0.118609406952965
"1315","2016-03-11",50,375,55,480,0.104166666666667,0.78125,0.114583333333333
"1316","2016-03-18",49,369,58,476,0.102941176470588,0.775210084033613,0.121848739495798
"1317","2016-03-24",52,359,53,464,0.112068965517241,0.773706896551724,0.114224137931034
"1318","2016-04-01",49,346,55,450,0.108888888888889,0.768888888888889,0.122222222222222
"1319","2016-04-08",52,341,50,443,0.117381489841986,0.769751693002257,0.112866817155756
"1320","2016-04-15",51,335,54,440,0.115909090909091,0.761363636363636,0.122727272727273
"1321","2016-04-22",48,332,51,431,0.111368909512761,0.77030162412993,0.118329466357309
"1322","2016-04-29",46,324,50,420,0.10952380952381,0.771428571428571,0.119047619047619
"1323","2016-05-06",44,318,53,415,0.106024096385542,0.766265060240964,0.127710843373494
"1324","2016-05-13",38,315,53,406,0.0935960591133005,0.775862068965517,0.130541871921182
"1325","2016-05-20",42,314,48,404,0.103960396039604,0.777227722772277,0.118811881188119
"1326","2016-05-27",44,314,46,404,0.108910891089109,0.777227722772277,0.113861386138614
"1327","2016-06-03",44,319,45,408,0.107843137254902,0.781862745098039,0.110294117647059
"1328","2016-06-10",45,323,46,414,0.108695652173913,0.780193236714976,0.111111111111111
"1329","2016-06-17",45,326,53,424,0.106132075471698,0.768867924528302,0.125
"1330","2016-06-24",43,325,53,421,0.102137767220903,0.771971496437055,0.125890736342043
"1331","2016-07-01",38,332,61,431,0.0881670533642692,0.77030162412993,0.1415313225058
"1332","2016-07-08",36,343,61,440,0.0818181818181818,0.779545454545455,0.138636363636364
"1333","2016-07-15",43,344,60,447,0.0961968680089486,0.769574944071588,0.134228187919463
"1334","2016-07-22",44,357,61,462,0.0952380952380952,0.772727272727273,0.132034632034632
"1335","2016-07-29",48,354,61,463,0.103671706263499,0.764578833693305,0.131749460043197
"1336","2016-08-05",44,362,58,464,0.0948275862068965,0.780172413793103,0.125
"1337","2016-08-12",44,375,62,481,0.0914760914760915,0.77962577962578,0.128898128898129
"1338","2016-08-19",45,382,64,491,0.0916496945010183,0.778004073319756,0.130346232179226
"1339","2016-08-26",48,379,62,489,0.098159509202454,0.775051124744376,0.12678936605317
"1340","2016-09-02",42,395,60,497,0.0845070422535211,0.79476861167002,0.120724346076459
"1341","2016-09-09",48,396,64,508,0.094488188976378,0.779527559055118,0.125984251968504
"1342","2016-09-16",48,394,64,506,0.0948616600790514,0.778656126482213,0.126482213438735
"1343","2016-09-23",49,402,60,511,0.0958904109589041,0.786692759295499,0.117416829745597
"1344","2016-09-30",51,407,64,522,0.0977011494252874,0.779693486590038,0.122605363984674
"1345","2016-10-07",50,413,61,524,0.0954198473282443,0.788167938931298,0.116412213740458
"1346","2016-10-14",51,431,57,539,0.0946196660482375,0.799628942486085,0.105751391465677
"1347","2016-10-21",51,445,57,553,0.0922242314647378,0.804701627486438,0.103074141048825
"1348","2016-10-28",54,450,53,557,0.0969479353680431,0.807899461400359,0.0951526032315979
"1349","2016-11-04",52,459,58,569,0.0913884007029877,0.806678383128295,0.101933216168717
"1350","2016-11-11",52,457,59,568,0.0915492957746479,0.804577464788732,0.10387323943662
"1351","2016-11-18",52,470,66,588,0.0884353741496599,0.799319727891156,0.112244897959184
"1352","2016-11-23",52,475,66,593,0.0876897133220911,0.801011804384486,0.111298482293423
"1353","2016-12-02",46,485,66,597,0.0770519262981575,0.812395309882747,0.110552763819095
"1354","2016-12-09",51,503,70,624,0.0817307692307692,0.806089743589744,0.112179487179487
"1355","2016-12-16",54,512,71,637,0.0847723704866562,0.803767660910518,0.111459968602826
"1356","2016-12-23",58,526,69,653,0.0888208269525268,0.805513016845329,0.105666156202144
"1357","2016-12-30",56,532,70,658,0.0851063829787234,0.808510638297872,0.106382978723404
"1358","2017-01-06",57,534,74,665,0.0857142857142857,0.803007518796993,0.111278195488722
"1359","2017-01-13",59,537,63,659,0.0895295902883156,0.814871016691957,0.0955993930197269
"1360","2017-01-20",60,559,75,694,0.0864553314121038,0.805475504322767,0.10806916426513
"1361","2017-01-27",61,579,72,712,0.0856741573033708,0.813202247191011,0.101123595505618
"1362","2017-02-03",66,596,67,729,0.0905349794238683,0.817558299039781,0.0919067215363512
"1363","2017-02-10",66,607,68,741,0.0890688259109312,0.819163292847503,0.0917678812415655
"1364","2017-02-17",72,614,65,751,0.0958721704394141,0.817576564580559,0.0865512649800266
"1365","2017-02-24",69,624,61,754,0.0915119363395226,0.827586206896552,0.0809018567639257
"1366","2017-03-03",61,633,62,756,0.0806878306878307,0.837301587301587,0.082010582010582
"1367","2017-03-10",61,639,68,768,0.0794270833333333,0.83203125,0.0885416666666667
"1368","2017-03-17",61,658,70,789,0.0773130544993663,0.833967046894804,0.0887198986058302
"1369","2017-03-24",58,673,78,809,0.0716934487021014,0.831891223733004,0.0964153275648949
"1370","2017-03-31",70,685,69,824,0.0849514563106796,0.831310679611651,0.0837378640776699
"1371","2017-04-07",71,695,73,839,0.0846245530393325,0.828367103694875,0.0870083432657926
"1372","2017-04-13",64,706,77,847,0.0755608028335301,0.833530106257379,0.0909090909090909
"1373","2017-04-21",60,718,79,857,0.0700116686114352,0.837806301050175,0.0921820303383897
"1374","2017-04-28",63,730,77,870,0.0724137931034483,0.839080459770115,0.0885057471264368
"1375","2017-05-05",67,734,76,877,0.0763968072976055,0.836944127708096,0.0866590649942987
"1376","2017-05-12",66,742,77,885,0.0745762711864407,0.838418079096045,0.0870056497175141
"1377","2017-05-19",66,759,76,901,0.0732519422863485,0.842397336293008,0.0843507214206437
"1378","2017-05-26",65,766,77,908,0.0715859030837004,0.843612334801762,0.0848017621145375
"1379","2017-06-02",68,771,77,916,0.074235807860262,0.841703056768559,0.084061135371179
"1380","2017-06-09",66,780,81,927,0.0711974110032362,0.841423948220065,0.087378640776699
"1381","2017-06-16",69,782,82,933,0.0739549839228296,0.838156484458735,0.0878885316184352
"1382","2017-06-23",72,792,77,941,0.0765143464399575,0.841657810839533,0.0818278427205101
"1383","2017-06-30",71,792,77,940,0.075531914893617,0.842553191489362,0.0819148936170213
"1384","2017-07-07",74,804,74,952,0.0777310924369748,0.84453781512605,0.0777310924369748
"1385","2017-07-14",72,804,76,952,0.0756302521008403,0.84453781512605,0.0798319327731093
"1386","2017-07-21",75,803,72,950,0.0789473684210526,0.845263157894737,0.0757894736842105
"1387","2017-07-28",77,810,71,958,0.0803757828810021,0.845511482254697,0.0741127348643006
"1388","2017-08-04",74,807,73,954,0.0775681341719077,0.845911949685535,0.0765199161425577
"1389","2017-08-11",76,801,72,949,0.0800842992623815,0.84404636459431,0.0758693361433087
"1390","2017-08-18",81,799,66,946,0.0856236786469345,0.8446088794926,0.0697674418604651
"1391","2017-08-25",80,796,64,940,0.0851063829787234,0.846808510638298,0.0680851063829787
"1392","2017-09-01",81,794,68,943,0.0858960763520679,0.841993637327678,0.0721102863202545
"1393","2017-09-08",76,793,75,944,0.0805084745762712,0.840042372881356,0.0794491525423729
"1394","2017-09-15",74,795,67,936,0.0790598290598291,0.849358974358974,0.0715811965811966
"1395","2017-09-22",77,790,68,935,0.0823529411764706,0.844919786096257,0.0727272727272727
"1396","2017-09-29",82,794,64,940,0.0872340425531915,0.84468085106383,0.0680851063829787
"1397","2017-10-06",79,792,65,936,0.0844017094017094,0.846153846153846,0.0694444444444444
"1398","2017-10-13",79,786,63,928,0.0851293103448276,0.84698275862069,0.0678879310344828
"1399","2017-10-20",80,771,62,913,0.0876232201533406,0.84446878422782,0.067907995618839
"1400","2017-10-27",74,769,66,909,0.0814081408140814,0.845984598459846,0.0726072607260726
