"","Date","WTISpotPriceBBL","BrentSpotPriceBBL","OilRigCount","GasRigCount","MiscRigCount","TotalRigCount","PercOilRig","PercGasRig"
"1","1987-07-17",22.44,20.63,559,337,26,922,0.606290672451193,0.365509761388286
"2","1987-07-24",20.58,19.58,565,331,21,917,0.616139585605234,0.360959651035987
"3","1987-07-31",21.43,20.03,605,346,22,973,0.621788283658787,0.355601233299075
"4","1987-08-07",21.01,19.65,613,349,21,983,0.623601220752798,0.355035605289929
"5","1987-08-14",20.53,19.25,620,352,26,998,0.62124248496994,0.352705410821643
"6","1987-08-21",19.2,18.1,627,354,31,1012,0.619565217391304,0.349802371541502
"7","1987-08-28",19.44,18.2,665,361,23,1049,0.63393708293613,0.344137273593899
"8","1987-09-04",19.34,18.13,704,369,26,1099,0.640582347588717,0.335759781619654
"9","1987-09-11",19.42,18.18,718,364,26,1108,0.648014440433213,0.328519855595668
"10","1987-09-18",19.58,18.3,711,367,23,1101,0.645776566757493,0.333333333333333
"11","1987-09-25",19.47,18.6,718,356,20,1094,0.656307129798903,0.325411334552102
"12","1987-10-02",19.88,18.65,721,367,39,1127,0.639751552795031,0.32564330079858
"13","1987-10-09",19.67,18.6,723,378,3,1104,0.654891304347826,0.342391304347826
"14","1987-10-16",20.23,19,725,391,18,1134,0.639329805996473,0.344797178130512
"15","1987-10-23",20.18,18.98,740,372,18,1130,0.654867256637168,0.329203539823009
"16","1987-10-30",19.96,18.8,738,374,19,1131,0.652519893899204,0.330680813439434
"17","1987-11-06",18.73,17.95,734,387,20,1141,0.643295354951797,0.339176161262051
"18","1987-11-13",18.89,17.8,760,393,21,1174,0.647359454855196,0.334752981260647
"19","1987-11-20",18.87,17.6,746,386,20,1152,0.647569444444444,0.335069444444444
"20","1987-11-27",18.63,17.78,750,389,22,1161,0.645994832041344,0.335055986218777
"21","1987-12-04",18.68,18,757,394,1,1152,0.657118055555556,0.342013888888889
"22","1987-12-11",18.31,17.73,764,399,18,1181,0.646909398814564,0.337849280270957
"23","1987-12-18",15.57,15.6,745,405,18,1168,0.637842465753425,0.346746575342466
"24","1988-01-08",17.33,16.88,689,390,23,1102,0.625226860254084,0.353901996370236
"25","1988-01-15",16.92,16.65,641,392,21,1054,0.608159392789374,0.371916508538899
"26","1988-01-22",16.99,16.7,611,390,25,1026,0.59551656920078,0.380116959064327
"27","1988-01-29",16.97,16.28,573,366,25,964,0.594398340248963,0.379668049792531
"28","1988-02-05",17.34,16.1,580,381,25,986,0.588235294117647,0.386409736308316
"29","1988-02-12",16.84,15.75,557,385,26,968,0.575413223140496,0.397727272727273
"30","1988-02-19",16.73,15.55,575,377,26,978,0.587934560327198,0.385480572597137
"31","1988-02-26",15.77,14.65,592,365,26,983,0.602238046795524,0.371312309257375
"32","1988-03-04",15.63,14,591,360,27,978,0.604294478527607,0.368098159509202
"33","1988-03-11",16.2,14.88,572,342,32,946,0.604651162790698,0.361522198731501
"34","1988-03-18",16.61,14.93,583,326,34,943,0.618239660657476,0.345705196182397
"35","1988-03-25",17.07,15.45,580,322,33,935,0.620320855614973,0.344385026737968
"36","1988-04-08",16.87,15.55,566,315,35,916,0.617903930131004,0.343886462882096
"37","1988-04-15",18.32,16.85,560,310,34,904,0.619469026548673,0.342920353982301
"38","1988-04-22",18.13,17.15,566,307,35,908,0.623348017621145,0.338105726872247
"39","1988-04-29",18.1,16.6,541,308,31,880,0.614772727272727,0.35
"40","1988-05-06",17.63,16.45,563,308,26,897,0.627647714604236,0.343366778149387
"41","1988-05-13",17.53,16.5,557,299,27,883,0.630804077010193,0.338618346545866
"42","1988-05-20",17.41,16.45,571,291,30,892,0.640134529147982,0.326233183856502
"43","1988-05-27",17.45,16.25,576,295,34,905,0.63646408839779,0.325966850828729
"44","1988-06-03",17.51,16.45,562,304,32,898,0.625835189309577,0.338530066815145
"45","1988-06-10",16.7,15.85,544,310,35,889,0.611923509561305,0.348706411698538
"46","1988-06-17",16.43,15.48,550,321,34,905,0.607734806629834,0.354696132596685
"47","1988-06-24",16.03,15.15,558,301,35,894,0.624161073825503,0.33668903803132
"48","1988-07-01",14.92,13.95,572,314,35,921,0.621064060803475,0.340933767643865
"49","1988-07-08",15.42,15.05,573,318,35,926,0.618790496760259,0.34341252699784
"50","1988-07-15",14.85,14.25,565,297,37,899,0.628476084538376,0.330367074527253
"51","1988-07-22",16.27,15.83,560,308,35,903,0.62015503875969,0.341085271317829
"52","1988-07-29",16.37,15.75,549,314,31,894,0.614093959731544,0.351230425055928
"53","1988-08-05",15.31,14.85,575,340,30,945,0.608465608465609,0.35978835978836
"54","1988-08-12",15.54,14.98,572,335,33,940,0.608510638297872,0.356382978723404
"55","1988-08-19",15.77,14.85,566,342,29,937,0.604055496264675,0.364994663820704
"56","1988-08-26",15.35,14.5,561,346,28,935,0.6,0.370053475935829
"57","1988-09-02",14.79,14,526,381,26,933,0.563772775991426,0.408360128617363
"58","1988-09-09",14.14,13.25,513,399,26,938,0.546908315565032,0.425373134328358
"59","1988-09-16",14.5,13.23,499,396,26,921,0.541802388707926,0.429967426710098
"60","1988-09-23",14.26,13.2,510,383,24,917,0.556161395856052,0.417666303162486
"61","1988-09-30",13.33,11.93,523,370,25,918,0.569716775599129,0.403050108932462
"62","1988-10-07",12.99,11.35,514,372,28,914,0.562363238512035,0.407002188183807
"63","1988-10-14",14.9,13.2,524,373,28,925,0.566486486486487,0.403243243243243
"64","1988-10-21",14.22,13.48,526,379,28,933,0.563772775991426,0.406216505894963
"65","1988-10-28",13.79,12.6,504,391,28,923,0.546045503791983,0.423618634886241
"66","1988-11-04",14.04,12.75,505,416,21,942,0.536093418259023,0.441613588110403
"67","1988-11-11",13.99,13.03,471,403,23,897,0.525083612040134,0.449275362318841
"68","1988-11-18",13.47,12.08,491,409,23,923,0.531960996749729,0.443120260021669
"69","1988-11-25",15.43,14.7,494,395,22,911,0.542261251372119,0.433589462129528
"70","1988-12-02",15.69,14.8,487,397,21,905,0.538121546961326,0.438674033149171
"71","1988-12-09",15.9,14.9,512,390,20,922,0.55531453362256,0.422993492407809
"72","1988-12-16",16.81,15.6,510,400,20,930,0.548387096774194,0.43010752688172
"73","1988-12-23",16.63,15.38,519,400,21,940,0.552127659574468,0.425531914893617
"74","1988-12-30",17.12,16.23,505,384,19,908,0.556167400881057,0.422907488986784
"75","1989-01-06",17.56,16.85,475,375,22,872,0.544724770642202,0.430045871559633
"76","1989-01-13",18.49,17.4,470,346,24,840,0.55952380952381,0.411904761904762
"77","1989-01-20",18.85,18.15,412,354,23,789,0.522179974651458,0.448669201520913
"78","1989-01-27",17.74,17.18,414,362,21,797,0.519447929736512,0.454203262233375
"79","1989-02-03",17.51,16.75,396,363,21,780,0.507692307692308,0.465384615384615
"80","1989-02-10",17.11,16.4,389,334,23,746,0.521447721179625,0.447721179624665
"81","1989-02-17",18.6,17.15,392,350,24,766,0.511749347258486,0.456919060052219
"82","1989-02-24",18.06,17.05,391,341,25,757,0.516512549537649,0.450462351387054
"83","1989-03-03",18.67,17.73,400,337,24,761,0.525624178712221,0.442838370565046
"84","1989-03-10",18.53,17.63,398,327,18,743,0.535666218034993,0.440107671601615
"85","1989-03-17",20.34,19.3,405,314,21,740,0.547297297297297,0.424324324324324
"86","1989-03-31",20.27,20.45,417,341,21,779,0.535301668806162,0.437740693196406
"87","1989-04-07",20.03,19.4,429,325,24,778,0.551413881748072,0.417737789203085
"88","1989-04-14",20.68,19.63,433,304,21,758,0.571240105540897,0.401055408970976
"89","1989-04-21",23.38,21.6,430,317,20,767,0.560625814863103,0.413298565840939
"90","1989-04-28",20.38,20.15,426,305,20,751,0.567243675099867,0.40612516644474
"91","1989-05-05",20.08,19.4,436,311,17,764,0.570680628272251,0.407068062827225
"92","1989-05-12",20.12,19.2,451,310,10,771,0.584954604409857,0.402075226977951
"93","1989-05-19",20.58,18.3,425,304,8,737,0.576662143826323,0.412483039348711
"94","1989-05-26",19.55,17.65,419,323,7,749,0.559412550066756,0.431241655540721
"95","1989-06-02",20.18,18.15,429,341,14,784,0.54719387755102,0.434948979591837
"96","1989-06-09",19.87,17.95,427,353,11,791,0.539823008849558,0.446270543615676
"97","1989-06-16",19.98,16.65,409,367,19,795,0.514465408805031,0.461635220125786
"98","1989-06-23",19.71,18.03,428,368,14,810,0.528395061728395,0.454320987654321
"99","1989-06-30",20.29,18.28,439,364,14,817,0.537331701346389,0.445532435740514
"100","1989-07-07",20.78,17.85,436,373,16,825,0.528484848484848,0.452121212121212
"101","1989-07-14",20.36,17.9,424,382,14,820,0.517073170731707,0.465853658536585
"102","1989-07-21",19.86,17.83,417,399,14,830,0.502409638554217,0.480722891566265
"103","1989-07-28",17.96,16.38,445,413,12,870,0.511494252873563,0.474712643678161
"104","1989-08-04",18.05,16.15,445,420,9,874,0.509153318077803,0.480549199084668
"105","1989-08-11",18.46,17,433,414,11,858,0.504662004662005,0.482517482517483
"106","1989-08-18",18.82,16.83,426,463,14,903,0.471760797342193,0.512735326688815
"107","1989-08-25",18.53,16.95,442,456,11,909,0.486248624862486,0.501650165016502
"108","1989-09-01",18.88,17.33,451,474,11,936,0.481837606837607,0.506410256410256
"109","1989-09-08",19.77,17.83,449,490,11,950,0.472631578947368,0.515789473684211
"110","1989-09-15",19.96,17.88,468,486,11,965,0.484974093264249,0.503626943005181
"111","1989-09-22",19.21,17.53,472,485,10,967,0.488107549120993,0.501551189245088
"112","1989-09-29",20.15,18.23,480,489,9,978,0.49079754601227,0.5
"113","1989-10-06",19.89,18.45,468,485,7,960,0.4875,0.505208333333333
"114","1989-10-13",20.91,19.6,498,475,8,981,0.507645259938838,0.484199796126402
"115","1989-10-20",20.04,19.2,502,480,10,992,0.506048387096774,0.483870967741936
"116","1989-10-27",19.79,18.7,516,482,12,1010,0.510891089108911,0.477227722772277
"117","1989-11-03",20.23,19,539,491,12,1042,0.517274472168906,0.471209213051823
"118","1989-11-10",19.84,19.05,545,487,13,1045,0.521531100478469,0.466028708133971
"119","1989-11-17",19.93,18.75,529,499,12,1040,0.508653846153846,0.479807692307692
"120","1989-11-24",19.84,18.48,516,514,7,1037,0.497589199614272,0.49566055930569
"121","1989-12-01",20.26,18.68,534,522,6,1062,0.502824858757062,0.491525423728814
"122","1989-12-08",20.41,19.15,528,523,7,1058,0.499054820415879,0.494328922495274
"123","1989-12-15",21.13,19.68,552,519,8,1079,0.511584800741427,0.481000926784059
"124","1989-12-22",21.31,20.5,548,505,8,1061,0.516493873704053,0.475966069745523
"125","1989-12-29",21.84,21.05,533,502,7,1042,0.511516314779271,0.481765834932822
"126","1990-01-05",23.07,23.13,532,488,9,1029,0.517006802721089,0.47424684159378
"127","1990-01-12",23.17,22.13,527,484,8,1019,0.517173699705594,0.474975466143278
"128","1990-01-19",23.7,21.28,494,462,8,964,0.512448132780083,0.479253112033195
"129","1990-01-26",22.56,20.63,482,447,8,937,0.514407684098186,0.477054429028815
"130","1990-02-02",23.04,20.73,489,434,8,931,0.525241675617616,0.466165413533835
"131","1990-02-09",21.82,19.75,495,397,7,899,0.550611790878754,0.441601779755284
"132","1990-02-16",22.46,19.88,498,413,7,918,0.542483660130719,0.449891067538126
"133","1990-02-23",21.13,18.78,485,405,7,897,0.540691192865106,0.451505016722408
"134","1990-03-02",21.36,19.18,478,409,7,894,0.534675615212528,0.457494407158837
"135","1990-03-09",20.42,18.68,482,435,6,923,0.522210184182015,0.471289274106176
"136","1990-03-16",20.09,18.4,479,424,5,908,0.527533039647577,0.466960352422908
"137","1990-03-23",20.28,17.88,474,414,5,893,0.530795072788354,0.463605823068309
"138","1990-03-30",20.34,17.95,516,425,5,946,0.545454545454545,0.449260042283298
"139","1990-04-06",19.15,17.1,487,445,5,937,0.51974386339381,0.474919957310566
"140","1990-04-20",17.9,16.35,462,467,3,932,0.495708154506438,0.501072961373391
"141","1990-04-27",18.57,16.43,472,451,4,927,0.509169363538296,0.486515641855448
"142","1990-05-04",17.98,15.58,475,450,5,930,0.510752688172043,0.483870967741936
"143","1990-05-11",18.96,16.73,479,458,4,941,0.509032943676939,0.486716259298619
"144","1990-05-18",18.78,17.08,504,465,3,972,0.518518518518519,0.478395061728395
"145","1990-05-25",16.12,15.95,514,485,2,1001,0.513486513486514,0.484515484515485
"146","1990-06-01",17.51,15.43,507,475,1,983,0.515768056968464,0.483214649033571
"147","1990-06-08",16.78,14.68,496,489,6,991,0.50050454086781,0.493440968718466
"148","1990-06-15",16.64,15.15,491,500,8,999,0.491491491491492,0.500500500500501
"149","1990-06-22",16.5,15.4,496,516,9,1021,0.485798237022527,0.505386875612145
"150","1990-06-29",17.05,15.73,491,516,13,1020,0.481372549019608,0.505882352941176
"151","1990-07-06",16.49,15.35,487,509,15,1011,0.481701285855589,0.503461918892186
"152","1990-07-13",18.37,17.03,491,495,15,1001,0.490509490509491,0.494505494505495
"153","1990-07-20",19.61,18,509,496,17,1022,0.498043052837573,0.4853228962818
"154","1990-07-27",20.07,19.03,508,466,22,996,0.51004016064257,0.467871485943775
"155","1990-08-03",23.79,24.13,494,457,15,966,0.511387163561077,0.473084886128364
"156","1990-08-10",26.38,26.3,507,472,13,992,0.511088709677419,0.475806451612903
"157","1990-08-17",28.65,28.45,511,459,17,987,0.517730496453901,0.465045592705167
"158","1990-08-24",31.1,31.65,510,475,17,1002,0.508982035928144,0.474051896207585
"159","1990-08-31",27.45,27.8,544,453,15,1012,0.537549407114625,0.447628458498024
"160","1990-09-07",30.09,31.45,570,454,15,1039,0.548604427333975,0.436958614051973
"161","1990-09-14",31.79,33.35,579,466,15,1060,0.54622641509434,0.439622641509434
"162","1990-09-21",36.21,36.95,572,467,16,1055,0.54218009478673,0.442654028436019
"163","1990-09-28",39.53,41,560,470,17,1047,0.534861509073544,0.448901623686724
"164","1990-10-05",37.87,39.05,590,456,18,1064,0.554511278195489,0.428571428571429
"165","1990-10-12",39.42,39.9,588,453,15,1056,0.556818181818182,0.428977272727273
"166","1990-10-19",33.82,33.2,597,480,12,1089,0.548209366391185,0.440771349862259
"167","1990-10-26",33.03,33.73,607,488,12,1107,0.5483288166215,0.440831074977416
"168","1990-11-02",33.95,35.05,620,513,11,1144,0.541958041958042,0.448426573426573
"169","1990-11-09",33.91,34.25,614,480,30,1124,0.54626334519573,0.427046263345196
"170","1990-11-16",29.91,30.55,606,474,23,1103,0.549410698096102,0.42973708068903
"171","1990-11-23",32.35,32.05,620,513,42,1175,0.527659574468085,0.436595744680851
"172","1990-11-30",29.08,31.2,639,495,41,1175,0.543829787234043,0.421276595744681
"173","1990-12-07",26.61,28.3,646,495,38,1179,0.547921967769296,0.419847328244275
"174","1990-12-14",26.6,28.45,657,457,37,1151,0.570807993049522,0.397046046915726
"175","1990-12-21",27.08,26.9,634,427,28,1089,0.5821854912764,0.392102846648301
"176","1990-12-28",27.58,27.43,639,424,23,1086,0.588397790055249,0.390423572744015
"177","1991-01-04",24.88,24.08,651,432,25,1108,0.587545126353791,0.389891696750903
"178","1991-01-11",27.43,26.05,612,413,23,1048,0.583969465648855,0.394083969465649
"179","1991-01-18",20.05,19.1,631,410,24,1065,0.592488262910798,0.384976525821596
"180","1991-01-25",24.15,20.8,639,396,16,1051,0.607992388201713,0.376784015223597
"181","1991-02-01",21.33,20.8,574,409,13,996,0.576305220883534,0.410642570281125
"182","1991-02-08",21.78,20.65,575,408,14,997,0.576730190571715,0.409227683049147
"183","1991-02-15",20.73,18.35,553,407,17,977,0.566018423746162,0.416581371545548
"184","1991-02-22",17.43,17.8,555,397,15,967,0.573940020682523,0.410548086866598
"185","1991-03-01",19.43,19.33,529,400,20,949,0.557428872497366,0.421496311907271
"186","1991-03-08",19.34,19.1,534,394,20,948,0.563291139240506,0.415611814345992
"187","1991-03-15",19.88,19.05,513,374,21,908,0.564977973568282,0.411894273127753
"188","1991-03-22",19.88,18.95,503,389,19,911,0.552140504939627,0.427003293084523
"189","1991-04-05",20.03,18.35,480,382,19,881,0.54483541430193,0.433598183881952
"190","1991-04-12",21.54,19.93,472,383,19,874,0.540045766590389,0.438215102974828
"191","1991-04-19",21.16,19.18,450,367,18,835,0.538922155688623,0.439520958083832
"192","1991-04-26",21.28,19.63,444,347,33,824,0.538834951456311,0.421116504854369
"193","1991-05-03",21.43,19.55,425,350,30,805,0.527950310559006,0.434782608695652
"194","1991-05-10",21.25,19.53,418,353,31,802,0.521197007481297,0.440149625935162
"195","1991-05-17",21.19,18.75,422,352,44,818,0.515892420537897,0.430317848410758
"196","1991-05-24",21.04,18.83,451,361,34,846,0.533096926713948,0.426713947990544
"197","1991-05-31",21.16,19,435,352,37,824,0.527912621359223,0.427184466019417
"198","1991-06-07",20.28,18.28,463,344,43,850,0.544705882352941,0.404705882352941
"199","1991-06-14",19.7,17.7,479,345,47,871,0.549942594718714,0.39609644087256
"200","1991-06-21",20.1,18.43,485,340,41,866,0.560046189376444,0.392609699769053
"201","1991-06-28",20.56,18.48,505,337,39,881,0.573212258796822,0.382519863791146
"202","1991-07-05",20.91,18.7,488,332,39,859,0.568102444703143,0.386495925494761
"203","1991-07-12",21.74,19.78,467,338,39,844,0.553317535545024,0.400473933649289
"204","1991-07-19",22.16,20.28,462,328,38,828,0.557971014492754,0.396135265700483
"205","1991-07-26",21.48,19.73,470,329,46,845,0.556213017751479,0.389349112426036
"206","1991-08-02",21.35,19.4,485,314,32,831,0.583634175691937,0.377858002406739
"207","1991-08-09",21.64,19.58,452,318,26,796,0.5678391959799,0.399497487437186
"208","1991-08-16",21.29,19.35,447,326,24,797,0.560853199498118,0.409033877038896
"209","1991-08-23",21.78,19.85,434,332,26,792,0.547979797979798,0.419191919191919
"210","1991-08-30",22.28,20.53,438,339,22,799,0.548185231539424,0.424280350438048
"211","1991-09-06",21.56,20.13,436,336,26,798,0.546365914786967,0.421052631578947
"212","1991-09-13",21.71,20.35,419,309,30,758,0.552770448548813,0.407651715039578
"213","1991-09-20",22.02,20.55,440,303,27,770,0.571428571428571,0.393506493506494
"214","1991-09-27",22.42,21.48,436,306,33,775,0.56258064516129,0.394838709677419
"215","1991-10-04",22.64,21.83,434,320,32,786,0.552162849872774,0.407124681933842
"216","1991-10-11",23.19,22.08,438,317,41,796,0.550251256281407,0.398241206030151
"217","1991-10-18",24.12,23,427,340,30,797,0.535759096612296,0.426599749058971
"218","1991-10-25",23.18,22.35,432,341,28,801,0.539325842696629,0.425717852684145
"219","1991-11-01",23.85,22.53,432,335,26,793,0.544766708701135,0.422446406052963
"220","1991-11-08",23,21.8,436,329,31,796,0.547738693467337,0.413316582914573
"221","1991-11-15",22.79,21.63,455,322,26,803,0.566625155666252,0.400996264009963
"222","1991-11-22",21.85,20.15,476,333,19,828,0.57487922705314,0.402173913043478
"223","1991-11-29",21.48,20.08,484,321,17,822,0.588807785888078,0.39051094890511
"224","1991-12-06",19.87,19.05,498,299,17,814,0.611793611793612,0.367321867321867
"225","1991-12-13",20.09,19.05,479,306,17,802,0.597256857855362,0.381546134663342
"226","1991-12-20",18.28,18.55,465,312,20,797,0.583437892095358,0.391468005018821
"227","1991-12-27",18.82,17.75,433,316,21,770,0.562337662337662,0.41038961038961
"228","1992-01-03",19.22,18.5,427,313,24,764,0.55890052356021,0.409685863874346
"229","1992-01-10",18.26,17.23,405,312,15,732,0.55327868852459,0.426229508196721
"230","1992-01-17",19.11,18.48,412,291,13,716,0.575418994413408,0.406424581005587
"231","1992-01-24",18.75,18.33,383,291,12,686,0.558309037900875,0.424198250728863
"232","1992-01-31",18.93,18.15,375,265,13,653,0.57427258805513,0.405819295558959
"233","1992-02-07",19.91,18.58,383,277,14,674,0.568249258160237,0.410979228486647
"234","1992-02-14",19.42,18.63,370,279,12,661,0.559757942511347,0.422087745839637
"235","1992-02-21",18.6,18,373,280,14,667,0.559220389805098,0.419790104947526
"236","1992-02-28",18.69,17.45,387,273,13,673,0.575037147102526,0.405646359583952
"237","1992-03-06",18.53,17.3,382,262,16,660,0.578787878787879,0.396969696969697
"238","1992-03-13",19.16,17.73,384,249,16,649,0.591679506933744,0.38366718027735
"239","1992-03-20",18.78,17.75,380,245,18,643,0.590979782270607,0.381026438569207
"240","1992-03-27",19.19,17.85,377,242,20,639,0.589984350547731,0.378716744913928
"241","1992-04-03",20.25,18.63,382,253,23,658,0.580547112462006,0.384498480243161
"242","1992-04-10",20.45,19.05,373,251,24,648,0.575617283950617,0.387345679012346
"243","1992-04-24",20.05,18.9,355,251,17,623,0.569823434991974,0.402889245585875
"244","1992-05-01",20.88,19.83,354,260,20,634,0.558359621451104,0.410094637223975
"245","1992-05-08",20.85,19.63,361,256,18,635,0.568503937007874,0.403149606299213
"246","1992-05-15",20.7,19.7,371,262,19,652,0.569018404907976,0.401840490797546
"247","1992-05-22",20.79,19.58,361,257,20,638,0.565830721003135,0.40282131661442
"248","1992-05-29",22.13,20.7,344,263,22,629,0.546899841017488,0.4181240063593
"249","1992-06-05",22.65,21.35,331,256,23,610,0.542622950819672,0.419672131147541
"250","1992-06-12",22.28,21.28,335,242,19,596,0.562080536912752,0.406040268456376
"251","1992-06-19",22.16,21.13,352,264,16,632,0.556962025316456,0.417721518987342
"252","1992-06-26",22.42,21.3,353,276,16,645,0.547286821705426,0.427906976744186
"253","1992-07-03",22.08,20.65,340,291,17,648,0.524691358024691,0.449074074074074
"254","1992-07-10",21.25,20,343,306,18,667,0.51424287856072,0.458770614692654
"255","1992-07-17",21.56,20.2,352,320,17,689,0.51088534107402,0.4644412191582
"256","1992-07-24",21.95,20.6,351,318,19,688,0.510174418604651,0.462209302325581
"257","1992-07-31",21.83,20.38,357,317,16,690,0.517391304347826,0.459420289855072
"258","1992-08-07",21.27,19.75,356,329,24,709,0.502115655853315,0.464033850493653
"259","1992-08-14",21.31,19.88,330,326,22,678,0.486725663716814,0.480825958702065
"260","1992-08-21",21.19,19.68,334,336,19,689,0.484760522496372,0.48766328011611
"261","1992-08-28",21.3,19.65,315,333,20,668,0.471556886227545,0.498502994011976
"262","1992-09-04",21.77,20.03,342,345,19,706,0.484419263456091,0.488668555240793
"263","1992-09-11",22,20.35,325,346,16,687,0.473071324599709,0.503639010189229
"264","1992-09-18",21.96,20.3,348,356,16,720,0.483333333333333,0.494444444444444
"265","1992-09-25",21.51,20.33,366,377,12,755,0.48476821192053,0.499337748344371
"266","1992-10-02",21.93,20.4,364,381,11,756,0.481481481481481,0.503968253968254
"267","1992-10-09",21.99,20.48,377,399,11,787,0.479034307496823,0.506988564167726
"268","1992-10-16",22.31,20.78,393,399,11,803,0.489414694894147,0.496886674968867
"269","1992-10-23",21.11,20.03,415,403,12,830,0.5,0.485542168674699
"270","1992-10-30",20.68,19.13,410,415,13,838,0.489260143198091,0.495226730310263
"271","1992-11-06",20.26,19.13,412,429,12,853,0.483001172332943,0.502930832356389
"272","1992-11-13",20.04,19.05,430,440,15,885,0.485875706214689,0.497175141242938
"273","1992-11-20",20.37,19.48,407,469,14,890,0.457303370786517,0.526966292134832
"274","1992-11-27",20.29,19.08,421,466,12,899,0.468298109010011,0.518353726362625
"275","1992-12-04",18.95,18.35,432,470,12,914,0.472647702407002,0.514223194748359
"276","1992-12-11",19.09,18.2,425,494,11,930,0.456989247311828,0.531182795698925
"277","1992-12-18",19.81,18.3,381,528,26,935,0.407486631016043,0.564705882352941
"278","1992-12-23",19.97,18.23,378,525,25,928,0.407327586206897,0.56573275862069
"279","1992-12-30",19.63,17.83,368,527,27,922,0.399132321041215,0.571583514099783
"280","1993-01-08",18.9,17.23,356,515,32,903,0.394241417497231,0.570321151716501
"281","1993-01-15",18.89,17.28,336,467,35,838,0.400954653937948,0.55727923627685
"282","1993-01-22",18.64,17.08,325,434,35,794,0.409319899244333,0.546599496221663
"283","1993-01-29",20.27,18.48,321,401,40,762,0.421259842519685,0.526246719160105
"284","1993-02-05",20.27,18.7,304,374,42,720,0.422222222222222,0.519444444444445
"285","1993-02-12",19.96,18.48,307,350,41,698,0.439828080229226,0.501432664756447
"286","1993-02-19",19.69,18.3,306,313,37,656,0.466463414634146,0.477134146341463
"287","1993-02-26",20.53,18.83,327,300,36,663,0.493212669683258,0.452488687782805
"288","1993-03-05",20.85,19.6,311,277,32,620,0.501612903225806,0.446774193548387
"289","1993-03-12",20.38,18.83,312,257,31,600,0.52,0.428333333333333
"290","1993-03-19",20.05,18.58,318,270,26,614,0.517915309446254,0.439739413680782
"291","1993-03-26",20.42,18.55,320,267,23,610,0.524590163934426,0.437704918032787
"292","1993-03-31",20.44,18.7,326,278,23,627,0.519936204146731,0.443381180223286
"293","1993-04-08",20.22,18.53,314,278,23,615,0.510569105691057,0.452032520325203
"294","1993-04-16",20.09,18.5,319,262,22,603,0.529021558872305,0.434494195688226
"295","1993-04-23",19.93,18.63,320,265,23,608,0.526315789473684,0.435855263157895
"296","1993-04-30",20.54,18.85,319,268,22,609,0.523809523809524,0.440065681444992
"297","1993-05-07",20.43,18.98,319,278,20,617,0.517017828200972,0.450567260940032
"298","1993-05-14",19.51,18.4,316,283,20,619,0.510500807754443,0.45718901453958
"299","1993-05-21",19.6,18.05,321,298,22,641,0.500780031201248,0.464898595943838
"300","1993-05-28",20.04,18.43,334,315,22,671,0.497764530551416,0.469448584202683
"301","1993-06-04",19.79,18.25,340,325,21,686,0.495626822157434,0.473760932944606
"302","1993-06-11",18.99,17.63,365,327,19,711,0.513361462728551,0.459915611814346
"303","1993-06-18",18.71,17.13,344,321,16,681,0.505139500734214,0.47136563876652
"304","1993-06-25",18.83,17.23,351,335,16,702,0.5,0.477207977207977
"305","1993-07-02",17.93,16.63,364,353,15,732,0.497267759562842,0.48224043715847
"306","1993-07-09",17.92,16.53,353,346,14,713,0.495091164095372,0.485273492286115
"307","1993-07-16",17.29,16.6,362,346,12,720,0.502777777777778,0.480555555555556
"308","1993-07-23",17.67,16.85,376,376,13,765,0.491503267973856,0.491503267973856
"309","1993-07-30",17.94,16.85,385,380,11,776,0.496134020618557,0.489690721649485
"310","1993-08-06",17.3,16.38,389,377,10,776,0.501288659793814,0.485824742268041
"311","1993-08-13",18.14,16.93,404,371,11,786,0.513994910941476,0.472010178117048
"312","1993-08-20",18.09,16.68,400,395,10,805,0.496894409937888,0.490683229813665
"313","1993-08-27",18.82,17.05,396,417,9,822,0.481751824817518,0.507299270072993
"314","1993-09-03",17.72,16.33,405,419,10,834,0.485611510791367,0.502398081534772
"315","1993-09-10",16.74,15.43,405,421,9,835,0.48502994011976,0.504191616766467
"316","1993-09-17",17.1,15.55,423,422,11,856,0.494158878504673,0.492990654205608
"317","1993-09-24",17.52,16.1,440,420,6,866,0.508083140877598,0.484988452655889
"318","1993-10-01",18.63,17.08,427,422,7,856,0.498831775700935,0.492990654205608
"319","1993-10-08",18.53,16.98,435,414,7,856,0.508177570093458,0.483644859813084
"320","1993-10-15",18.24,16.7,443,409,8,860,0.515116279069767,0.475581395348837
"321","1993-10-22",17.92,16.48,450,402,8,860,0.523255813953488,0.467441860465116
"322","1993-10-29",16.97,15.43,452,410,8,870,0.519540229885057,0.471264367816092
"323","1993-11-05",17.09,15.73,444,418,8,870,0.510344827586207,0.480459770114943
"324","1993-11-12",16.72,15.08,453,412,7,872,0.519495412844037,0.472477064220184
"325","1993-11-19",16.55,15.25,449,401,7,857,0.52392065344224,0.467911318553092
"326","1993-11-26",15.53,14.28,465,400,6,871,0.533869115958668,0.459242250287026
"327","1993-12-03",15.03,13.95,443,427,6,876,0.505707762557078,0.487442922374429
"328","1993-12-10",15.04,13.8,443,417,8,868,0.51036866359447,0.480414746543779
"329","1993-12-17",13.98,13.85,445,433,5,883,0.5039637599094,0.490373725934315
"330","1993-12-22",14.61,13.6,408,430,5,843,0.483985765124555,0.510083036773428
"331","1993-12-29",14.45,13.13,385,423,6,814,0.472972972972973,0.51965601965602
"332","1994-01-07",15.33,14.63,357,442,8,807,0.442379182156134,0.547707558859975
"333","1994-01-14",14.81,14.1,365,420,7,792,0.460858585858586,0.53030303030303
"334","1994-01-21",14.85,14.23,356,413,9,778,0.457583547557841,0.530848329048843
"335","1994-01-28",15.37,14.65,345,423,10,778,0.443444730077121,0.543701799485861
"336","1994-02-04",15.63,14.93,335,405,12,752,0.445478723404255,0.538563829787234
"337","1994-02-11",14.71,13.7,346,406,12,764,0.452879581151832,0.531413612565445
"338","1994-02-18",14.21,13,337,403,12,752,0.44813829787234,0.535904255319149
"339","1994-02-25",14.48,13.33,330,406,11,747,0.441767068273092,0.543507362784471
"340","1994-03-04",14.57,13.43,322,412,9,743,0.433378196500673,0.554508748317631
"341","1994-03-11",14.47,13.7,320,405,8,733,0.43656207366985,0.552523874488404
"342","1994-03-18",14.88,14.05,330,404,9,743,0.44414535666218,0.543741588156124
"343","1994-03-25",15.19,14.58,323,391,11,725,0.44551724137931,0.539310344827586
"344","1994-03-31",14.78,13.25,320,402,10,732,0.437158469945355,0.549180327868853
"345","1994-04-08",15.57,14.3,309,390,10,709,0.435825105782793,0.550070521861777
"346","1994-04-15",16.58,15.23,303,407,10,720,0.420833333333333,0.565277777777778
"347","1994-04-22",17.84,16.28,318,403,11,732,0.434426229508197,0.550546448087432
"348","1994-04-29",16.92,15.35,326,393,11,730,0.446575342465753,0.538356164383562
"349","1994-05-06",17.74,16.25,323,383,13,719,0.44923504867872,0.532684283727399
"350","1994-05-13",18.2,16.5,319,388,15,722,0.441828254847645,0.537396121883657
"351","1994-05-20",18.93,16.23,314,369,14,697,0.450502152080344,0.529411764705882
"352","1994-05-27",18.02,16.08,314,398,15,727,0.43191196698762,0.547455295735901
"353","1994-06-03",18.11,16.13,316,410,16,742,0.425876010781671,0.55256064690027
"354","1994-06-10",18.48,16.38,328,410,14,752,0.436170212765957,0.545212765957447
"355","1994-06-17",20.72,17.13,342,409,18,769,0.444733420026008,0.53185955786736
"356","1994-06-24",19.28,17.4,341,402,18,761,0.448094612352168,0.528252299605782
"357","1994-07-01",19.52,17.65,333,415,18,766,0.434725848563969,0.54177545691906
"358","1994-07-08",19.48,17,340,412,16,768,0.442708333333333,0.536458333333333
"359","1994-07-15",19.89,18.15,337,421,15,773,0.435963777490298,0.544631306597671
"360","1994-07-22",19.59,17.58,344,420,15,779,0.441591784338896,0.539152759948652
"361","1994-07-29",20.3,18.48,349,407,15,771,0.452658884565499,0.527885862516213
"362","1994-08-05",19.37,17.78,336,421,14,771,0.43579766536965,0.546044098573281
"363","1994-08-12",18.05,17.1,311,428,14,753,0.413014608233732,0.568393094289509
"364","1994-08-19",17.56,16.13,320,438,14,772,0.414507772020725,0.567357512953368
"365","1994-08-26",17.14,15.85,312,443,13,768,0.40625,0.576822916666667
"366","1994-09-02",17.52,15.88,308,463,13,784,0.392857142857143,0.590561224489796
"367","1994-09-09",17.53,15.93,306,463,13,782,0.391304347826087,0.592071611253197
"368","1994-09-16",16.84,15.3,326,467,11,804,0.40547263681592,0.580845771144279
"369","1994-09-23",17.76,16.3,339,484,13,836,0.405502392344498,0.578947368421053
"370","1994-09-30",18.36,16.73,348,476,14,838,0.41527446300716,0.568019093078759
"371","1994-10-07",18.27,16.93,343,472,13,828,0.414251207729469,0.570048309178744
"372","1994-10-14",16.98,15.58,348,467,13,828,0.420289855072464,0.564009661835749
"373","1994-10-21",17.31,16.35,336,471,12,819,0.41025641025641,0.575091575091575
"374","1994-10-28",18.25,17.18,341,459,13,813,0.419434194341943,0.564575645756458
"375","1994-11-04",18.76,18,355,456,13,824,0.430825242718447,0.553398058252427
"376","1994-11-11",18.07,17.38,365,454,14,833,0.438175270108043,0.545018007202881
"377","1994-11-18",17.47,16.45,357,468,14,839,0.425506555423123,0.557806912991657
"378","1994-11-25",NA,17,367,461,14,842,0.435866983372922,0.54750593824228
"379","1994-12-02",17,16.35,359,454,14,827,0.43409915356711,0.548972188633616
"380","1994-12-09",17.12,16.08,361,465,15,841,0.429250891795482,0.552913198573127
"381","1994-12-16",16.84,15.48,350,442,15,807,0.433705080545229,0.547707558859975
"382","1994-12-23",17.41,15.55,351,448,14,813,0.431734317343173,0.551045510455105
"383","1994-12-30",17.77,16.23,348,428,15,791,0.439949431099874,0.541087231352718
"384","1995-01-05",17.76,16.13,328,425,13,766,0.428198433420366,0.554830287206266
"385","1995-01-13",17.52,16.2,339,407,11,757,0.44782034346103,0.537648612945839
"386","1995-01-20",18.46,17.23,319,408,9,736,0.433423913043478,0.554347826086957
"387","1995-01-27",17.95,16.38,315,405,11,731,0.430916552667579,0.554035567715458
"388","1995-02-03",18.78,17.4,319,393,12,724,0.44060773480663,0.542817679558011
"389","1995-02-10",18.47,16.85,321,375,10,706,0.454674220963173,0.531161473087819
"390","1995-02-17",18.94,17.4,336,376,12,724,0.464088397790055,0.519337016574586
"391","1995-02-24",18.7,17.1,326,355,15,696,0.468390804597701,0.510057471264368
"392","1995-03-03",18.63,16.68,333,337,14,684,0.486842105263158,0.492690058479532
"393","1995-03-10",17.92,16.5,334,330,11,675,0.494814814814815,0.488888888888889
"394","1995-03-17",18.27,16.55,326,328,13,667,0.488755622188906,0.491754122938531
"395","1995-03-24",18.68,17.65,313,327,12,652,0.480061349693252,0.501533742331288
"396","1995-03-31",19.18,17.98,302,334,12,648,0.466049382716049,0.515432098765432
"397","1995-04-07",19.67,18.45,310,347,12,669,0.463378176382661,0.518684603886398
"398","1995-04-13",19.16,17.98,325,340,11,676,0.480769230769231,0.502958579881657
"399","1995-04-21",20.46,19.18,334,337,14,685,0.487591240875912,0.491970802919708
"400","1995-04-28",20.36,18.98,343,321,16,680,0.504411764705882,0.472058823529412
"401","1995-05-05",20.33,18.85,323,321,20,664,0.48644578313253,0.483433734939759
"402","1995-05-12",19.55,18.23,329,340,20,689,0.477503628447025,0.493468795355588
"403","1995-05-19",20.06,18.43,323,332,18,673,0.479940564635958,0.49331352154532
"404","1995-05-26",18.7,17.8,325,348,17,690,0.471014492753623,0.504347826086957
"405","1995-06-02",19.14,17.9,317,343,17,677,0.468242245199409,0.506646971935007
"406","1995-06-09",18.83,17.68,303,350,21,674,0.449554896142433,0.519287833827893
"407","1995-06-16",18.8,17.75,307,340,23,670,0.458208955223881,0.507462686567164
"408","1995-06-23",17.81,16.4,301,362,21,684,0.440058479532164,0.529239766081871
"409","1995-06-30",17.38,16.58,278,364,24,666,0.417417417417417,0.546546546546547
"410","1995-07-07",17.14,16.1,299,390,25,714,0.418767507002801,0.546218487394958
"411","1995-07-14",17.32,15.8,298,398,24,720,0.413888888888889,0.552777777777778
"412","1995-07-21",17.07,15.35,305,391,23,719,0.424200278164117,0.543810848400556
"413","1995-07-28",17.43,15.93,301,417,21,739,0.407307171853857,0.564276048714479
"414","1995-08-04",17.74,16.08,318,398,16,732,0.434426229508197,0.543715846994536
"415","1995-08-11",17.86,16.23,327,394,18,739,0.442489851150203,0.533152909336942
"416","1995-08-18",17.87,16.03,330,395,19,744,0.443548387096774,0.530913978494624
"417","1995-08-25",19.91,16.15,333,410,20,763,0.436435124508519,0.53735255570118
"418","1995-09-01",18.08,16.25,330,421,21,772,0.427461139896373,0.545336787564767
"419","1995-09-08",18.44,16.93,332,415,19,766,0.433420365535248,0.54177545691906
"420","1995-09-15",18.94,17.18,335,405,19,759,0.44137022397892,0.533596837944664
"421","1995-09-22",17.27,16.4,337,418,20,775,0.434838709677419,0.539354838709677
"422","1995-09-29",17.54,16.58,333,405,17,755,0.441059602649007,0.536423841059603
"423","1995-10-06",17.03,15.75,333,405,16,754,0.441644562334218,0.537135278514589
"424","1995-10-13",17.38,15.98,335,412,16,763,0.439056356487549,0.53997378768021
"425","1995-10-20",17.44,15.8,328,422,15,765,0.428758169934641,0.551633986928105
"426","1995-10-27",17.54,16.35,331,417,13,761,0.434954007884363,0.54796320630749
"427","1995-11-03",17.93,16.88,332,418,14,764,0.43455497382199,0.547120418848168
"428","1995-11-10",17.83,16.83,332,424,13,769,0.431729518855657,0.551365409622887
"429","1995-11-17",18.56,17.03,328,440,11,779,0.421052631578947,0.564826700898588
"430","1995-11-22",17.93,16.9,327,436,11,774,0.422480620155039,0.563307493540052
"431","1995-12-01",18.43,17.18,322,440,11,773,0.416558861578267,0.569210866752911
"432","1995-12-08",18.97,17.73,333,427,12,772,0.431347150259067,0.553108808290155
"433","1995-12-15",19.51,18.15,329,424,12,765,0.430065359477124,0.554248366013072
"434","1995-12-22",19.12,18.18,328,422,12,762,0.430446194225722,0.553805774278215
"435","1995-12-29",19.54,18.65,314,420,11,745,0.421476510067114,0.563758389261745
"436","1996-01-05",20.26,19.5,297,404,10,711,0.417721518987342,0.568213783403657
"437","1996-01-12",18.28,17.58,290,406,8,704,0.411931818181818,0.576704545454545
"438","1996-01-19",18.94,17.53,300,408,8,716,0.418994413407821,0.569832402234637
"439","1996-01-26",17.68,16.7,291,404,8,703,0.413940256045519,0.574679943100996
"440","1996-02-02",17.83,17.05,295,389,9,693,0.425685425685426,0.561327561327561
"441","1996-02-09",17.83,17.23,281,407,7,695,0.40431654676259,0.585611510791367
"442","1996-02-16",19.16,18.2,285,417,5,707,0.403111739745403,0.58981612446959
"443","1996-02-23",20.97,18.85,269,431,5,705,0.381560283687943,0.611347517730496
"444","1996-03-01",19.45,18.55,265,436,6,707,0.374823196605375,0.616690240452617
"445","1996-03-08",19.66,18.85,290,421,8,719,0.403337969401947,0.585535465924896
"446","1996-03-15",21.99,19.3,284,403,6,693,0.40981240981241,0.581529581529582
"447","1996-03-22",22.85,21.15,297,422,6,725,0.409655172413793,0.582068965517241
"448","1996-03-29",21.43,20.33,296,425,7,728,0.406593406593407,0.583791208791209
"449","1996-04-12",24.29,22.73,283,445,7,735,0.385034013605442,0.605442176870748
"450","1996-04-19",23.96,19.53,285,451,11,747,0.381526104417671,0.603748326639893
"451","1996-04-26",22.33,20.05,284,460,13,757,0.375165125495377,0.607661822985469
"452","1996-05-03",21.19,19.38,285,449,15,749,0.380507343124166,0.599465954606142
"453","1996-05-10",21.01,19.23,290,474,8,772,0.375647668393782,0.613989637305699
"454","1996-05-17",20.64,18.05,285,463,9,757,0.376486129458388,0.611624834874505
"455","1996-05-24",21.58,19.73,291,478,6,775,0.375483870967742,0.616774193548387
"456","1996-05-31",19.77,18.1,288,472,5,765,0.376470588235294,0.616993464052288
"457","1996-06-07",20.28,18.4,301,475,5,781,0.385403329065301,0.608194622279129
"458","1996-06-14",20.28,17.83,304,464,5,773,0.393272962483829,0.60025873221216
"459","1996-06-21",20.38,18.45,295,465,5,765,0.38562091503268,0.607843137254902
"460","1996-06-28",20.92,19.28,293,480,4,777,0.377091377091377,0.617760617760618
"461","1996-07-05",21.65,19.99,292,486,4,782,0.373401534526854,0.621483375959079
"462","1996-07-12",21.9,19.93,291,493,4,788,0.369289340101523,0.625634517766498
"463","1996-07-19",20.95,19.45,296,490,4,790,0.374683544303797,0.620253164556962
"464","1996-07-26",20.13,18.92,280,482,12,774,0.361757105943152,0.622739018087855
"465","1996-08-02",21.35,19.63,297,483,21,801,0.370786516853933,0.602996254681648
"466","1996-08-09",21.6,20.05,305,483,21,809,0.377008652657602,0.597033374536465
"467","1996-08-16",22.6,21.3,298,484,23,805,0.370186335403727,0.601242236024845
"468","1996-08-23",22.23,20.78,297,499,32,828,0.358695652173913,0.602657004830918
"469","1996-08-30",22.25,20.98,288,493,31,812,0.354679802955665,0.607142857142857
"470","1996-09-06",23.85,22.43,293,492,5,790,0.370886075949367,0.622784810126582
"471","1996-09-13",24.5,23.83,300,503,5,808,0.371287128712871,0.622524752475248
"472","1996-09-20",23.6,21.78,309,511,5,825,0.374545454545455,0.619393939393939
"473","1996-09-27",24.6,22.9,302,515,5,822,0.367396593673966,0.626520681265207
"474","1996-10-04",24.75,23.88,311,503,5,819,0.37973137973138,0.614163614163614
"475","1996-10-11",24.65,23.85,312,505,10,827,0.37726723095526,0.610640870616687
"476","1996-10-18",25.8,25.18,319,514,12,845,0.377514792899408,0.608284023668639
"477","1996-10-25",24.8,24.13,336,503,14,853,0.39390386869871,0.58968347010551
"478","1996-11-01",23,22.3,346,491,2,839,0.412395709177592,0.585220500595948
"479","1996-11-08",23.6,22.4,349,486,3,838,0.416467780429594,0.579952267303103
"480","1996-11-15",24.15,23.28,366,481,2,849,0.431095406360424,0.566548881036514
"481","1996-11-22",24.15,23.86,374,475,2,851,0.439482961222092,0.558166862514689
"482","1996-11-27",23.7,23.07,382,477,2,861,0.443670150987224,0.554006968641115
"483","1996-12-06",25.6,24.56,366,488,2,856,0.427570093457944,0.570093457943925
"484","1996-12-13",24.45,22.83,364,475,2,841,0.43281807372176,0.564803804994055
"485","1996-12-20",26.1,23.96,360,496,2,858,0.41958041958042,0.578088578088578
"486","1996-12-27",25.2,23.55,353,496,2,851,0.414806110458284,0.582843713278496
"487","1997-01-03",25.55,24.19,363,480,2,845,0.429585798816568,0.568047337278107
"488","1997-01-10",26.15,24.22,346,477,2,825,0.419393939393939,0.578181818181818
"489","1997-01-17",25.4,22.87,335,482,1,818,0.409535452322738,0.589242053789731
"490","1997-01-24",23.85,22.8,333,481,1,815,0.408588957055215,0.590184049079755
"491","1997-01-31",24.15,23.28,333,481,1,815,0.408588957055215,0.590184049079755
"492","1997-02-07",22.3,NA,350,481,2,833,0.420168067226891,0.577430972388956
"493","1997-02-14",22.4,20.56,362,496,2,860,0.42093023255814,0.576744186046512
"494","1997-02-21",21.6,20.13,354,508,1,863,0.410196987253766,0.58864426419467
"495","1997-02-28",20.3,19.44,357,481,2,840,0.425,0.572619047619048
"496","1997-03-07",21.35,NA,363,517,2,882,0.41156462585034,0.586167800453515
"497","1997-03-14",21.3,19.44,366,517,2,885,0.413559322033898,0.584180790960452
"498","1997-03-21",21.7,19.39,379,525,1,905,0.41878453038674,0.580110497237569
"499","1997-03-28",NA,18.53,400,514,1,915,0.437158469945355,0.561748633879782
"500","1997-04-04",19.15,17.25,384,533,1,918,0.418300653594771,0.580610021786492
"501","1997-04-11",19.5,17.54,371,541,1,913,0.406352683461117,0.592552026286966
"502","1997-04-18",19.9,17.26,372,511,2,885,0.420338983050847,0.577401129943503
"503","1997-04-25",19.8,18.07,365,520,4,889,0.410573678290214,0.584926884139483
"504","1997-05-02",19.6,17.7,369,508,4,881,0.418842224744608,0.576617480136209
"505","1997-05-09",20.45,18.62,374,535,4,913,0.409638554216867,0.585980284775466
"506","1997-05-16",22.1,19.77,368,545,4,917,0.401308615049073,0.59432933478735
"507","1997-05-23",21.25,20.15,387,557,4,948,0.408227848101266,0.587552742616034
"508","1997-05-30",21,18.99,395,562,4,961,0.411030176899063,0.58480749219563
"509","1997-06-06",19,17.43,404,580,4,988,0.408906882591093,0.587044534412956
"510","1997-06-13",18.95,16.83,393,585,4,982,0.40020366598778,0.595723014256619
"511","1997-06-20",18.6,17.09,393,570,3,966,0.406832298136646,0.590062111801242
"512","1997-06-27",19.42,18,392,572,2,966,0.405797101449275,0.592132505175984
"513","1997-07-11",19.39,18,368,593,3,964,0.381742738589212,0.615145228215768
"514","1997-07-18",19.22,18.21,381,578,3,962,0.396049896049896,0.600831600831601
"515","1997-07-25",19.71,18.77,398,583,3,984,0.404471544715447,0.592479674796748
"516","1997-08-01",20.27,19.33,410,582,3,995,0.412060301507538,0.584924623115578
"517","1997-08-08",19.58,18.56,429,555,3,987,0.434650455927052,0.562310030395137
"518","1997-08-15",20.08,18.77,417,580,2,999,0.417417417417417,0.580580580580581
"519","1997-08-22",19.7,NA,406,596,3,1005,0.403980099502488,0.593034825870647
"520","1997-08-29",19.66,17.98,383,594,3,980,0.390816326530612,0.606122448979592
"521","1997-09-05",19.61,18.15,404,625,3,1032,0.391472868217054,0.60562015503876
"522","1997-09-12",19.37,18.06,386,623,3,1012,0.381422924901186,0.615612648221344
"523","1997-09-19",19.37,18.32,387,603,3,993,0.389728096676737,0.607250755287009
"524","1997-09-26",20.87,19.36,392,603,3,998,0.392785571142285,0.604208416833667
"525","1997-10-03",22.86,21.29,384,613,4,1001,0.383616383616384,0.612387612387612
"526","1997-10-10",22.01,20.73,392,578,4,974,0.402464065708419,0.593429158110883
"527","1997-10-17",21.41,19.43,404,579,4,987,0.409321175278622,0.586626139817629
"528","1997-10-24",20.99,19.45,397,602,4,1003,0.395812562313061,0.600199401794616
"529","1997-10-31",21.1,19.42,373,640,4,1017,0.366764995083579,0.629301868239921
"530","1997-11-07",20.8,19.24,343,638,4,985,0.348223350253807,0.647715736040609
"531","1997-11-14",21.01,20.24,359,631,4,994,0.361167002012072,0.634808853118712
"532","1997-11-21",19.76,18.83,342,601,4,947,0.361140443505808,0.634635691657867
"533","1997-11-28",NA,18.96,371,630,4,1005,0.369154228855721,0.626865671641791
"534","1997-12-05",18.72,17.91,365,645,4,1014,0.359960552268245,0.636094674556213
"535","1997-12-12",18.21,17.12,361,647,4,1012,0.356719367588933,0.639328063241107
"536","1997-12-19",18.46,17.2,361,654,4,1019,0.354268891069676,0.64180569185476
"537","1997-12-26",18.19,NA,357,646,4,1007,0.354518371400199,0.641509433962264
"538","1998-01-02",17.41,15.77,366,633,4,1003,0.364905284147557,0.63110667996012
"539","1998-01-09",16.65,15.33,361,625,4,990,0.364646464646465,0.631313131313131
"540","1998-01-16",16.48,14.89,387,598,4,989,0.391304347826087,0.604651162790698
"541","1998-01-23",15.65,14.26,396,595,5,996,0.397590361445783,0.597389558232932
"542","1998-01-30",17.21,15.59,389,593,5,987,0.394123606889564,0.60081053698075
"543","1998-02-06",16.72,15.05,385,584,5,974,0.395277207392197,0.59958932238193
"544","1998-02-13",16.03,14.05,385,582,5,972,0.396090534979424,0.598765432098765
"545","1998-02-20",16.13,13.91,372,612,5,989,0.376137512639029,0.618806875631952
"546","1998-02-27",15.44,13.53,376,579,5,960,0.391666666666667,0.603125
"547","1998-03-06",14.9,12.85,360,592,5,957,0.376175548589342,0.618599791013584
"548","1998-03-13",14.19,12.25,321,617,4,942,0.340764331210191,0.654989384288747
"549","1998-03-20",14.31,12.35,321,613,3,937,0.342582710779082,0.654215581643543
"550","1998-03-27",16.84,14.92,304,583,3,890,0.341573033707865,0.655056179775281
"551","1998-04-03",16.08,13.63,295,577,3,875,0.337142857142857,0.659428571428572
"552","1998-04-17",15.49,14.06,294,601,3,898,0.32739420935412,0.669265033407572
"553","1998-04-24",13.23,13.32,278,599,3,880,0.315909090909091,0.680681818181818
"554","1998-05-01",16.25,14.6,272,601,3,876,0.310502283105023,0.686073059360731
"555","1998-05-08",15.21,13.94,271,571,3,845,0.320710059171598,0.675739644970414
"556","1998-05-15",14.51,14.33,281,592,3,876,0.320776255707763,0.675799086757991
"557","1998-05-22",14.81,14.33,269,583,3,855,0.314619883040936,0.68187134502924
"558","1998-05-29",15.21,14.03,269,551,2,822,0.327250608272506,0.670316301703163
"559","1998-06-05",15.13,13.95,270,590,2,862,0.31322505800464,0.684454756380511
"560","1998-06-12",12.66,11.62,267,599,2,868,0.307603686635945,0.690092165898618
"561","1998-06-19",11.8,10.89,271,589,3,863,0.314020857473928,0.682502896871379
"562","1998-06-26",14.21,12.04,261,560,2,823,0.317132442284326,0.680437424058323
"563","1998-07-03",NA,11.79,258,552,2,812,0.317733990147783,0.679802955665025
"564","1998-07-10",13.96,11.61,266,551,2,819,0.324786324786325,0.672771672771673
"565","1998-07-17",14.02,12.38,260,548,2,810,0.320987654320988,0.676543209876543
"566","1998-07-24",13.93,12.05,269,544,3,816,0.329656862745098,0.666666666666667
"567","1998-07-31",14.27,12.63,269,550,3,822,0.327250608272506,0.669099756690998
"568","1998-08-07",13.85,12.05,235,571,3,809,0.290482076637825,0.705809641532757
"569","1998-08-14",13.4,11.46,229,568,2,799,0.286608260325407,0.710888610763454
"570","1998-08-21",13.44,12.02,218,551,2,771,0.282749675745785,0.714656290531777
"571","1998-08-28",13.54,12.06,221,568,1,790,0.279746835443038,0.718987341772152
"572","1998-09-04",14.59,12.96,218,552,0,770,0.283116883116883,0.716883116883117
"573","1998-09-11",14.39,12.66,214,567,0,781,0.274007682458387,0.725992317541613
"574","1998-09-18",15.53,13.92,215,558,0,773,0.278137128072445,0.721862871927555
"575","1998-09-25",15.8,14.55,213,557,0,770,0.276623376623377,0.723376623376623
"576","1998-10-02",15.71,14.21,229,525,0,754,0.303713527851459,0.696286472148541
"577","1998-10-09",14.64,12.87,226,524,0,750,0.301333333333333,0.698666666666667
"578","1998-10-16",14.16,12.11,211,529,0,740,0.285135135135135,0.714864864864865
"579","1998-10-23",14.06,12.18,212,504,0,716,0.29608938547486,0.70391061452514
"580","1998-10-30",14.48,12,193,515,0,708,0.272598870056497,0.727401129943503
"581","1998-11-06",13.93,11.51,197,499,0,696,0.283045977011494,0.716954022988506
"582","1998-11-13",13.57,11.46,193,491,0,684,0.282163742690059,0.717836257309942
"583","1998-11-20",12.2,10.4,189,497,0,686,0.275510204081633,0.724489795918367
"584","1998-11-25",10.86,10.51,179,507,0,686,0.260932944606414,0.739067055393586
"585","1998-12-04",11.2,9.73,167,502,0,669,0.249626307922272,0.750373692077728
"586","1998-12-11",10.86,9.26,169,498,0,667,0.253373313343328,0.746626686656672
"587","1998-12-18",10.95,9.62,152,489,1,642,0.236760124610592,0.761682242990654
"588","1998-12-23",11.12,9.91,149,484,1,634,0.235015772870662,0.763406940063092
"589","1998-12-30",11.75,10.45,137,483,1,621,0.22061191626409,0.777777777777778
"590","1999-01-08",13.06,11.7,133,466,1,600,0.221666666666667,0.776666666666667
"591","1999-01-15",12.21,10.97,126,470,1,597,0.21105527638191,0.787269681742044
"592","1999-01-22",12.62,11.23,122,465,1,588,0.207482993197279,0.790816326530612
"593","1999-01-29",12.81,11.34,119,443,0,562,0.211743772241993,0.788256227758007
"594","1999-02-05",11.85,10.18,125,433,0,558,0.224014336917563,0.775985663082437
"595","1999-02-12",11.9,9.97,122,422,0,544,0.224264705882353,0.775735294117647
"596","1999-02-19",11.79,10.29,111,420,0,531,0.209039548022599,0.790960451977401
"597","1999-02-26",12.31,10.58,108,425,0,533,0.202626641651032,0.797373358348968
"598","1999-03-05",13.33,11.02,115,426,0,541,0.212569316081331,0.787430683918669
"599","1999-03-12",14.51,12.3,116,418,0,534,0.217228464419476,0.782771535580524
"600","1999-03-19",15.26,13.15,114,412,0,526,0.216730038022814,0.783269961977186
"601","1999-03-26",16.16,13.97,111,391,0,502,0.221115537848606,0.778884462151394
"602","1999-04-09",16.59,14.11,122,376,0,498,0.244979919678715,0.755020080321285
"603","1999-04-16",17.34,15.34,130,369,0,499,0.260521042084168,0.739478957915832
"604","1999-04-23",17.96,16.07,126,362,0,488,0.258196721311475,0.741803278688525
"605","1999-04-30",18.69,16.45,126,368,0,494,0.255060728744939,0.744939271255061
"606","1999-05-07",18.23,15.66,134,371,0,505,0.265346534653465,0.734653465346535
"607","1999-05-14",18.04,15.18,142,365,0,507,0.280078895463511,0.719921104536489
"608","1999-05-21",17.22,14.49,138,380,0,518,0.266409266409266,0.733590733590734
"609","1999-05-28",16.85,14.75,130,404,0,534,0.243445692883895,0.756554307116105
"610","1999-06-04",17.36,15.21,134,421,0,555,0.241441441441441,0.758558558558559
"611","1999-06-11",18.45,16.25,136,411,0,547,0.248628884826325,0.751371115173675
"612","1999-06-18",18.01,15.93,117,449,0,566,0.206713780918728,0.793286219081272
"613","1999-06-25",18.17,16.27,110,453,0,563,0.19538188277087,0.80461811722913
"614","1999-07-02",19.7,17.55,112,467,1,580,0.193103448275862,0.805172413793103
"615","1999-07-09",19.94,18.9,120,450,0,570,0.210526315789474,0.789473684210526
"616","1999-07-16",20.66,19.42,105,476,2,583,0.180102915951973,0.816466552315609
"617","1999-07-23",20.41,19.69,102,501,2,605,0.168595041322314,0.828099173553719
"618","1999-07-30",20.52,19.97,102,498,2,602,0.169435215946844,0.827242524916944
"619","1999-08-06",20.89,19.66,98,516,2,616,0.159090909090909,0.837662337662338
"620","1999-08-13",21.67,20.61,115,510,2,627,0.18341307814992,0.813397129186603
"621","1999-08-20",21.66,21.11,112,531,2,645,0.173643410852713,0.823255813953488
"622","1999-08-27",21.31,20.32,117,550,1,668,0.175149700598802,0.823353293413174
"623","1999-09-03",22,20.74,121,549,1,671,0.180327868852459,0.818181818181818
"624","1999-09-10",23.55,22.36,128,561,1,690,0.185507246376812,0.81304347826087
"625","1999-09-17",24.72,22.93,132,570,1,703,0.187766714082504,0.810810810810811
"626","1999-09-24",24.81,23.66,140,580,0,720,0.194444444444444,0.805555555555556
"627","1999-10-01",24.51,22.98,131,597,2,730,0.179452054794521,0.817808219178082
"628","1999-10-08",20.81,20.78,141,599,1,741,0.190283400809717,0.808367071524966
"629","1999-10-15",22.81,21.65,140,579,2,721,0.194174757281553,0.803051317614424
"630","1999-10-22",23.48,22.38,139,609,2,750,0.185333333333333,0.812
"631","1999-10-29",21.79,21.11,136,623,2,761,0.178712220762155,0.818659658344284
"632","1999-11-05",22.93,22.8,137,624,2,763,0.179554390563565,0.817824377457405
"633","1999-11-12",24.91,25.39,150,622,2,774,0.193798449612403,0.803617571059432
"634","1999-11-19",26.61,25.14,147,648,2,797,0.18444165621079,0.813048933500627
"635","1999-11-26",27.22,25.85,146,647,2,795,0.183647798742138,0.813836477987421
"636","1999-12-03",25.71,26.17,146,648,2,796,0.183417085427136,0.814070351758794
"637","1999-12-10",25.21,24.86,158,653,2,813,0.194341943419434,0.80319803198032
"638","1999-12-17",26.76,26.22,175,638,2,815,0.214723926380368,0.782822085889571
"639","1999-12-22",25.51,25.04,162,634,1,797,0.203262233375157,0.795483061480552
"640","1999-12-30",25.76,24.93,165,606,0,771,0.214007782101167,0.785992217898833
"641","2000-01-07",24.79,23.35,158,627,1,786,0.201017811704835,0.797709923664122
"642","2000-01-14",28.01,25.5,142,638,1,781,0.181818181818182,0.816901408450704
"643","2000-01-21",29.71,27.18,140,637,0,777,0.18018018018018,0.81981981981982
"644","2000-01-28",27.27,26.59,131,624,0,755,0.173509933774834,0.826490066225166
"645","2000-02-04",28.67,27.48,133,624,0,757,0.175693527080581,0.824306472919419
"646","2000-02-11",29.51,27.82,146,616,0,762,0.191601049868766,0.808398950131234
"647","2000-02-18",29.51,27.26,153,620,0,773,0.197930142302717,0.802069857697283
"648","2000-02-25",30.34,28.53,156,604,0,760,0.205263157894737,0.794736842105263
"649","2000-03-03",31.46,29.83,181,609,0,790,0.229113924050633,0.770886075949367
"650","2000-03-10",31.76,28.97,174,594,0,768,0.2265625,0.7734375
"651","2000-03-17",30.86,27.87,168,595,1,764,0.219895287958115,0.778795811518325
"652","2000-03-24",27.86,25.74,167,600,1,768,0.217447916666667,0.78125
"653","2000-03-31",26.86,23.98,173,601,1,775,0.223225806451613,0.775483870967742
"654","2000-04-20",27.29,23.57,206,610,1,817,0.252141982864137,0.746634026927785
"655","2000-04-28",25.71,23.79,199,598,1,798,0.24937343358396,0.74937343358396
"656","2000-05-05",27.37,24.93,201,632,0,833,0.241296518607443,0.758703481392557
"657","2000-05-12",29.64,27.98,196,634,0,830,0.236144578313253,0.763855421686747
"658","2000-05-19",30.02,29.01,198,651,0,849,0.23321554770318,0.76678445229682
"659","2000-05-26",29.76,30.09,201,662,1,864,0.232638888888889,0.766203703703704
"660","2000-06-02",30.34,29.35,196,668,2,866,0.226327944572748,0.771362586605081
"661","2000-06-09",30.22,29,197,643,0,840,0.23452380952381,0.76547619047619
"662","2000-06-16",32.35,28.68,205,666,0,871,0.235361653272101,0.764638346727899
"663","2000-06-23",34.76,31.02,203,690,0,893,0.227323628219485,0.772676371780515
"664","2000-06-30",32.44,31.58,202,718,0,920,0.219565217391304,0.780434782608696
"665","2000-07-07",30.26,30.62,198,715,0,913,0.216867469879518,0.783132530120482
"666","2000-07-14",31.31,30.82,212,716,0,928,0.228448275862069,0.771551724137931
"667","2000-07-21",28.56,26.68,213,736,1,950,0.224210526315789,0.774736842105263
"668","2000-07-28",28.22,25.96,210,764,1,975,0.215384615384615,0.783589743589744
"669","2000-08-04",29.94,28.01,208,772,1,981,0.212028542303772,0.786952089704383
"670","2000-08-11",31.02,29.44,209,765,2,976,0.214139344262295,0.783811475409836
"671","2000-08-18",31.97,30.76,206,786,2,994,0.207243460764588,0.790744466800805
"672","2000-08-25",34.01,33.26,200,794,2,996,0.200803212851406,0.79718875502008
"673","2000-09-01",33.42,35.09,202,816,1,1019,0.198233562315996,0.800785083415113
"674","2000-09-08",33.62,36.27,201,808,3,1012,0.198616600790514,0.798418972332016
"675","2000-09-15",35.87,33.68,194,816,2,1012,0.191699604743083,0.806324110671937
"676","2000-09-22",32.66,31.59,193,803,2,998,0.193386773547094,0.804609218436874
"677","2000-09-29",30.87,28.42,207,806,2,1015,0.203940886699507,0.794088669950739
"678","2000-10-06",30.86,29.62,200,833,2,1035,0.193236714975845,0.804830917874396
"679","2000-10-13",34.96,33.5,209,836,0,1045,0.2,0.8
"680","2000-10-20",34.31,30.16,210,844,0,1054,0.199240986717268,0.800759013282733
"681","2000-10-27",32.78,31.31,228,855,1,1084,0.210332103321033,0.788745387453875
"682","2000-11-03",32.62,30.81,232,845,1,1078,0.215213358070501,0.783858998144712
"683","2000-11-10",34.05,32.26,226,840,1,1067,0.211808809746954,0.787253983130272
"684","2000-11-17",35.62,33.09,232,824,1,1057,0.219489120151372,0.779564806054872
"685","2000-11-22",36.06,33.11,244,819,1,1064,0.229323308270677,0.769736842105263
"686","2000-12-01",32.06,31.59,255,834,1,1090,0.23394495412844,0.765137614678899
"687","2000-12-08",28.31,26.85,242,844,2,1088,0.222426470588235,0.775735294117647
"688","2000-12-15",28.86,24.44,244,862,1,1107,0.220415537488708,0.778681120144535
"689","2000-12-21",26.06,22.4,235,851,1,1087,0.216191352345906,0.782888684452622
"690","2000-12-29",26.72,22.58,234,879,1,1114,0.210053859964093,0.789048473967684
"691","2001-01-05",28.02,24.77,244,862,1,1107,0.220415537488708,0.778681120144535
"692","2001-01-12",30.07,25.63,234,886,1,1121,0.208742194469224,0.790365744870651
"693","2001-01-19",32.12,26.29,240,887,1,1128,0.212765957446809,0.786347517730497
"694","2001-01-26",29.79,27.04,236,879,1,1116,0.211469534050179,0.787634408602151
"695","2001-02-02",31.27,28.9,237,900,1,1138,0.208260105448155,0.790861159929701
"696","2001-02-09",30.93,29.53,234,903,0,1137,0.205804749340369,0.794195250659631
"697","2001-02-16",29.22,26.61,242,905,0,1147,0.210985178727114,0.789014821272886
"698","2001-02-23",28.83,26.12,236,885,0,1121,0.210526315789474,0.789473684210526
"699","2001-03-02",27.89,25.28,240,910,1,1151,0.208514335360556,0.790616854908775
"700","2001-03-09",27.97,25.78,252,903,3,1158,0.217616580310881,0.77979274611399
"701","2001-03-16",26.68,23.84,249,900,2,1151,0.216333622936577,0.781928757602085
"702","2001-03-23",27.31,23.94,256,904,3,1163,0.2201203783319,0.777300085984523
"703","2001-03-30",26.37,23.5,244,946,3,1193,0.20452640402347,0.792958927074602
"704","2001-04-06",27.07,24.02,253,944,3,1200,0.210833333333333,0.786666666666667
"705","2001-04-12",28.75,27.12,254,942,2,1198,0.212020033388982,0.786310517529215
"706","2001-04-20",27,25.57,244,967,2,1213,0.201154163231657,0.79719703215169
"707","2001-04-27",28.35,26.85,235,975,2,1212,0.193894389438944,0.804455445544555
"708","2001-05-04",28.41,27.59,244,971,2,1217,0.200493015612161,0.797863599013969
"709","2001-05-11",28.59,27.97,236,994,2,1232,0.191558441558442,0.806818181818182
"710","2001-05-18",29.9,29.3,231,992,2,1225,0.188571428571429,0.809795918367347
"711","2001-05-25",28.08,28.69,230,1030,2,1262,0.182250396196513,0.816164817749604
"712","2001-06-01",27.88,28.86,231,1037,2,1270,0.181889763779528,0.816535433070866
"713","2001-06-08",28.43,28.88,212,1051,1,1264,0.167721518987342,0.831487341772152
"714","2001-06-15",28.52,28.13,223,1042,1,1266,0.176145339652449,0.82306477093207
"715","2001-06-22",27.02,26.86,211,1063,3,1277,0.16523101018011,0.832419733750979
"716","2001-06-29",26.37,26.21,217,1056,2,1275,0.170196078431373,0.828235294117647
"717","2001-07-06",28.1,26.55,219,1054,2,1275,0.171764705882353,0.826666666666667
"718","2001-07-13",26.57,24.02,223,1068,2,1293,0.17246713070379,0.825986078886311
"719","2001-07-20",25.67,23.43,218,1058,2,1278,0.170579029733959,0.827856025039124
"720","2001-07-27",26.98,24.82,214,1050,2,1266,0.169036334913112,0.829383886255924
"721","2001-08-03",27.51,25.6,218,1047,1,1266,0.17219589257504,0.827014218009479
"722","2001-08-10",28.12,25.78,222,1025,1,1248,0.177884615384615,0.821314102564103
"723","2001-08-17",26.65,24.68,217,1024,1,1242,0.174718196457327,0.824476650563607
"724","2001-08-24",28.34,26.33,215,1035,1,1251,0.171862509992006,0.827338129496403
"725","2001-08-31",26.65,26.8,221,1030,1,1252,0.176517571884984,0.822683706070288
"726","2001-09-07",27.99,27.54,222,993,1,1216,0.182565789473684,0.816611842105263
"727","2001-09-14",29.59,29.22,220,981,1,1202,0.183028286189684,0.816139767054909
"728","2001-09-21",25.46,25.17,223,962,1,1186,0.188026981450253,0.811129848229342
"729","2001-09-28",23.44,21.87,215,953,0,1168,0.184075342465753,0.815924657534247
"730","2001-10-05",22.32,21.46,205,936,0,1141,0.179666958808063,0.820333041191937
"731","2001-10-12",22.49,20.57,208,933,0,1141,0.182296231375986,0.817703768624014
"732","2001-10-19",21.99,19.91,192,908,0,1100,0.174545454545455,0.825454545454545
"733","2001-10-26",22.07,20.31,187,876,0,1063,0.175917215428034,0.824082784571966
"734","2001-11-02",20.24,18.63,184,874,0,1058,0.173913043478261,0.826086956521739
"735","2001-11-09",22.23,20.72,176,834,0,1010,0.174257425742574,0.825742574257426
"736","2001-11-16",18.09,16.86,173,820,0,993,0.174219536757301,0.825780463242699
"737","2001-11-21",18.38,18.44,172,814,0,986,0.174442190669371,0.825557809330629
"738","2001-11-30",19.46,18.92,167,785,0,952,0.175420168067227,0.824579831932773
"739","2001-12-07",19.08,17.81,159,769,0,928,0.171336206896552,0.828663793103448
"740","2001-12-14",19.31,18.54,150,757,0,907,0.165380374862183,0.834619625137817
"741","2001-12-21",19.3,18.73,140,741,1,882,0.158730158730159,0.840136054421769
"742","2001-12-28",20.42,19.77,137,748,2,887,0.15445321307779,0.843291995490417
"743","2002-01-04",21.47,21.2,138,744,1,883,0.156285390713477,0.842582106455266
"744","2002-01-11",19.67,20.08,136,719,1,856,0.158878504672897,0.839953271028037
"745","2002-01-18",18.02,18.17,146,722,1,869,0.16800920598389,0.83084004602992
"746","2002-01-25",19.8,19.04,144,714,1,859,0.167636786961583,0.831199068684517
"747","2002-02-01",20.4,19.7,143,709,1,853,0.167643610785463,0.831184056271981
"748","2002-02-08",20.25,20.01,144,693,1,838,0.171837708830549,0.826968973747017
"749","2002-02-15",21.47,20.76,146,668,1,815,0.179141104294479,0.819631901840491
"750","2002-02-22",20.92,20.14,144,647,1,792,0.181818181818182,0.816919191919192
"751","2002-03-01",22.37,21.83,142,639,1,782,0.181585677749361,0.817135549872123
"752","2002-03-08",23.87,22.32,144,624,1,769,0.187256176853056,0.811443433029909
"753","2002-03-15",24.47,23.9,142,610,1,753,0.188579017264276,0.810092961487384
"754","2002-03-22",25.56,24.83,144,605,1,750,0.192,0.806666666666667
"755","2002-03-28",26.21,25.34,150,609,2,761,0.197109067017083,0.800262812089356
"756","2002-04-05",26.21,25.39,145,591,2,738,0.196476964769648,0.800813008130081
"757","2002-04-12",23.51,23.25,135,610,2,747,0.180722891566265,0.816599732262383
"758","2002-04-19",26.43,25.86,134,613,2,749,0.17890520694259,0.818424566088118
"759","2002-04-26",27.12,26.32,130,634,2,766,0.169712793733681,0.827676240208877
"760","2002-05-03",26.75,25.8,134,640,2,776,0.172680412371134,0.824742268041237
"761","2002-05-10",27.92,26.89,141,669,2,812,0.173645320197044,0.823891625615764
"762","2002-05-17",28.19,25.45,131,696,2,829,0.158021712907117,0.83956574185766
"763","2002-05-24",26.69,23.76,132,725,2,859,0.153667054714785,0.844004656577416
"764","2002-05-31",25.37,23.87,131,721,2,854,0.153395784543326,0.844262295081967
"765","2002-06-07",24.72,22.99,135,710,2,847,0.159386068476978,0.838252656434475
"766","2002-06-14",25.9,23.97,134,709,1,844,0.158767772511848,0.840047393364929
"767","2002-06-21",25.51,24.14,139,698,1,838,0.165871121718377,0.832935560859189
"768","2002-06-28",26.79,25.33,142,697,1,840,0.169047619047619,0.829761904761905
"769","2002-07-03",26.82,25.59,144,716,2,862,0.167053364269142,0.830626450116009
"770","2002-07-12",27.48,26.11,135,711,2,848,0.159198113207547,0.838443396226415
"771","2002-07-19",27.83,26.37,132,725,2,859,0.153667054714785,0.844004656577416
"772","2002-07-26",26.55,25.1,119,713,1,833,0.142857142857143,0.85594237695078
"773","2002-08-02",26.87,25.17,117,729,2,848,0.137971698113208,0.859669811320755
"774","2002-08-09",26.87,25.49,127,726,1,854,0.148711943793911,0.850117096018735
"775","2002-08-16",29.24,27.33,133,718,2,853,0.155920281359906,0.841735052754982
"776","2002-08-23",29.99,27.51,124,713,1,838,0.147971360381862,0.850835322195704
"777","2002-08-30",28.97,27.56,124,721,2,847,0.146399055489965,0.851239669421488
"778","2002-09-06",29.51,28.36,116,733,2,851,0.136310223266745,0.861339600470035
"779","2002-09-13",29.83,28.53,115,746,2,863,0.133256083429896,0.864426419466976
"780","2002-09-20",29.65,28.61,125,725,2,852,0.146713615023474,0.85093896713615
"781","2002-09-27",30.53,29,131,741,3,875,0.149714285714286,0.846857142857143
"782","2002-10-04",29.65,28.32,142,712,3,857,0.165694282380397,0.830805134189032
"783","2002-10-11",29.36,28.18,137,709,3,849,0.161366313309776,0.83510011778563
"784","2002-10-18",29.56,28.2,137,703,3,843,0.162514827995255,0.833926453143535
"785","2002-10-25",27.09,25.96,142,710,4,856,0.16588785046729,0.829439252336449
"786","2002-11-01",27.04,25.78,158,692,4,854,0.185011709601874,0.810304449648712
"787","2002-11-08",25.83,23.54,149,673,4,826,0.180387409200969,0.814769975786925
"788","2002-11-15",25.5,23.33,147,678,5,830,0.17710843373494,0.816867469879518
"789","2002-11-22",27.73,24.79,142,679,5,826,0.171912832929782,0.822033898305085
"790","2002-11-27",26.87,25.11,135,695,5,835,0.161676646706587,0.832335329341317
"791","2002-12-06",27.03,25.67,142,705,5,852,0.166666666666667,0.827464788732394
"792","2002-12-13",28.39,27.64,133,711,6,850,0.156470588235294,0.836470588235294
"793","2002-12-20",30.57,29.59,135,719,6,860,0.156976744186047,0.836046511627907
"794","2002-12-27",32.68,31.49,136,722,4,862,0.157772621809745,0.837587006960557
"795","2003-01-03",33.26,31.43,127,706,4,837,0.151732377538829,0.843488649940263
"796","2003-01-10",31.59,30.07,129,718,4,851,0.151586368977673,0.843713278495887
"797","2003-01-17",33.88,31.57,130,712,3,845,0.153846153846154,0.842603550295858
"798","2003-01-24",34.98,31.62,133,726,3,862,0.154292343387471,0.842227378190255
"799","2003-01-31",33.51,31.57,142,728,3,873,0.162657502863688,0.833906071019473
"800","2003-02-07",35.05,32.23,146,734,4,884,0.165158371040724,0.830316742081448
"801","2003-02-14",36.61,33.26,149,752,4,905,0.164640883977901,0.830939226519337
"802","2003-02-21",36.76,32.76,157,767,4,928,0.169181034482759,0.826508620689655
"803","2003-02-28",36.76,34,161,747,4,912,0.176535087719298,0.819078947368421
"804","2003-03-07",37.76,34.47,169,756,4,929,0.181916038751346,0.813778256189451
"805","2003-03-14",35.41,31.48,170,754,3,927,0.183387270765912,0.813376483279396
"806","2003-03-21",27.18,25.59,167,776,3,946,0.176532769556025,0.820295983086681
"807","2003-03-28",30.21,27.66,178,781,3,962,0.185031185031185,0.811850311850312
"808","2003-04-04",28.41,25.62,187,782,3,972,0.19238683127572,0.804526748971193
"809","2003-04-11",28.28,24.39,186,790,3,979,0.189989785495403,0.806945863125638
"810","2003-04-17",30.1,25.36,186,805,3,994,0.187122736418511,0.809859154929578
"811","2003-04-25",25.92,24.29,179,804,3,986,0.181541582150101,0.815415821501014
"812","2003-05-02",25.74,23.73,174,825,2,1001,0.173826173826174,0.824175824175824
"813","2003-05-09",27.65,25.55,170,848,3,1021,0.166503428011753,0.830558276199804
"814","2003-05-16",29.07,27.18,168,868,4,1040,0.161538461538462,0.834615384615385
"815","2003-05-23",29.74,27.14,164,882,4,1050,0.156190476190476,0.84
"816","2003-05-30",29.56,26.58,160,896,3,1059,0.151085930122757,0.846081208687441
"817","2003-06-06",31.26,28.38,159,892,3,1054,0.150853889943074,0.846299810246679
"818","2003-06-13",30.63,27.39,158,910,3,1071,0.147525676937442,0.849673202614379
"819","2003-06-20",30.63,27.13,148,915,4,1067,0.138706654170572,0.857544517338332
"820","2003-06-27",29.18,27.45,144,924,6,1074,0.134078212290503,0.860335195530726
"821","2003-07-03",30.39,28.63,148,925,4,1077,0.137418755803157,0.858867223769731
"822","2003-07-11",31.33,29.36,153,908,4,1065,0.143661971830986,0.852582159624413
"823","2003-07-18",31.96,29.2,154,932,3,1089,0.141414141414141,0.855831037649219
"824","2003-07-25",30.31,28.3,158,930,3,1091,0.144821264894592,0.852428964252979
"825","2003-08-01",32.23,29.63,156,937,4,1097,0.142206016408387,0.854147675478578
"826","2003-08-08",32.23,30.59,149,920,5,1074,0.138733705772812,0.856610800744879
"827","2003-08-15",31.01,29.18,158,933,5,1096,0.144160583941606,0.851277372262774
"828","2003-08-22",31.64,30.22,149,928,5,1082,0.137707948243993,0.857670979667283
"829","2003-08-29",31.76,30.38,154,944,4,1102,0.139745916515427,0.856624319419238
"830","2003-09-05",28.93,27.72,152,937,2,1091,0.139321723189734,0.85884509624198
"831","2003-09-12",28.26,26.52,165,928,2,1095,0.150684931506849,0.847488584474886
"832","2003-09-19",26.93,25.51,152,936,4,1092,0.139194139194139,0.857142857142857
"833","2003-09-26",28.21,27.02,148,943,4,1095,0.135159817351598,0.861187214611872
"834","2003-10-03",30.37,29.14,155,932,4,1091,0.142071494042163,0.854262144821265
"835","2003-10-10",32.01,31.13,155,950,4,1109,0.139765554553652,0.856627592425609
"836","2003-10-17",30.61,30.27,160,951,4,1115,0.143497757847534,0.852914798206278
"837","2003-10-24",29.99,30.01,158,930,2,1090,0.144954128440367,0.853211009174312
"838","2003-10-31",29.24,27.88,161,944,2,1107,0.145438121047877,0.852755194218609
"839","2003-11-07",30.73,28.73,160,952,2,1114,0.143626570915619,0.854578096947935
"840","2003-11-14",32.31,29.78,161,948,2,1111,0.144914491449145,0.853285328532853
"841","2003-11-21",32.26,29.79,157,948,2,1107,0.141824751580849,0.856368563685637
"842","2003-11-26",30.33,28.23,152,959,2,1113,0.136567834681042,0.861635220125786
"843","2003-12-05",30.68,28.87,153,956,2,1111,0.137713771377138,0.86048604860486
"844","2003-12-12",33.06,30.24,148,959,2,1109,0.133453561767358,0.864743011722272
"845","2003-12-19",32.81,31.03,154,956,2,1112,0.138489208633094,0.859712230215827
"846","2003-12-23",32.03,28.3,153,959,2,1114,0.137342908438061,0.860861759425494
"847","2003-12-31",32.51,30.3,158,966,2,1126,0.140319715808171,0.857904085257549
"848","2004-01-09",34.38,31.91,147,957,2,1106,0.132911392405063,0.865280289330922
"849","2004-01-16",35.16,31.26,145,980,2,1127,0.12866015971606,0.869565217391304
"850","2004-01-23",34.94,32.08,137,946,4,1087,0.126034958601656,0.870285188592456
"851","2004-01-30",33.16,29.53,142,938,4,1084,0.1309963099631,0.865313653136531
"852","2004-02-06",32.49,29.26,144,968,5,1117,0.128916741271262,0.866606982990152
"853","2004-02-13",34.51,30.96,155,951,5,1111,0.13951395139514,0.855985598559856
"854","2004-02-20",35.8,31.22,155,954,5,1114,0.139138240574506,0.856373429084381
"855","2004-02-27",36.08,32.94,158,971,5,1134,0.139329805996473,0.85626102292769
"856","2004-03-05",37.31,34.4,161,964,4,1129,0.142604074402126,0.853852967227635
"857","2004-03-12",36.21,32.76,169,961,4,1134,0.149029982363316,0.847442680776014
"858","2004-03-19",38.09,34.33,162,963,3,1128,0.143617021276596,0.853723404255319
"859","2004-03-26",35.61,32.51,165,982,3,1150,0.143478260869565,0.853913043478261
"860","2004-04-02",34.39,31.19,157,1000,3,1160,0.135344827586207,0.862068965517241
"861","2004-04-08",37.14,33.98,148,988,2,1138,0.130052724077329,0.868189806678383
"862","2004-04-16",37.7,33.85,156,992,2,1150,0.135652173913044,0.862608695652174
"863","2004-04-23",37.22,33.78,149,996,1,1146,0.130017452006981,0.869109947643979
"864","2004-04-30",37.31,35.23,158,1002,1,1161,0.136089577950043,0.863049095607235
"865","2004-05-07",39.98,37.25,158,994,1,1153,0.137033824804857,0.862098872506505
"866","2004-05-14",41.42,39.04,157,1004,1,1162,0.135111876075732,0.864027538726334
"867","2004-05-21",39.83,37.6,153,1018,1,1172,0.130546075085324,0.868600682593857
"868","2004-05-28",39.9,37,156,1012,1,1169,0.133447390932421,0.865697177074423
"869","2004-06-04",38.44,35.97,159,1008,1,1168,0.136130136986301,0.863013698630137
"870","2004-06-11",NA,35.23,162,1024,1,1187,0.13647851727043,0.86267902274642
"871","2004-06-18",38.68,35.43,163,1006,2,1171,0.139197267292912,0.859094790777114
"872","2004-06-25",37.34,34.25,170,1005,1,1176,0.144557823129252,0.854591836734694
"873","2004-07-02",38.37,35.36,168,1031,2,1201,0.139883430474605,0.858451290591174
"874","2004-07-09",39.9,37.58,177,1028,2,1207,0.146644573322287,0.851698425849213
"875","2004-07-16",41.1,38.49,168,1041,2,1211,0.138728323699422,0.85962014863749
"876","2004-07-23",41.82,39.59,168,1047,1,1216,0.138157894736842,0.861019736842105
"877","2004-07-30",43.72,41.47,171,1057,1,1229,0.139137510170871,0.860048820179007
"878","2004-08-06",43.95,42.63,170,1064,1,1235,0.137651821862348,0.861538461538462
"879","2004-08-13",46.61,44.13,168,1063,1,1232,0.136363636363636,0.862824675324675
"880","2004-08-20",47.6,45.46,174,1055,1,1230,0.141463414634146,0.857723577235772
"881","2004-08-27",43.11,40.72,169,1069,1,1239,0.136400322841001,0.862792574656981
"882","2004-09-03",43.94,41.07,166,1082,1,1249,0.132906325060048,0.866293034427542
"883","2004-09-10",42.84,41.03,170,1069,1,1240,0.137096774193548,0.862096774193548
"884","2004-09-17",45.63,43.08,163,1068,1,1232,0.132305194805195,0.866883116883117
"885","2004-09-24",48.86,46.13,165,1073,1,1239,0.13317191283293,0.866020984665053
"886","2004-10-01",50.16,46.86,161,1081,1,1243,0.129525341914722,0.869670152855994
"887","2004-10-08",53.4,49.41,169,1060,1,1230,0.13739837398374,0.861788617886179
"888","2004-10-15",54.89,51.02,167,1057,1,1225,0.136326530612245,0.862857142857143
"889","2004-10-22",55.83,52.28,178,1071,1,1250,0.1424,0.8568
"890","2004-10-29",51.78,48.16,179,1071,1,1251,0.14308553157474,0.856115107913669
"891","2004-11-05",49.65,44.37,190,1077,1,1268,0.149842271293375,0.849369085173502
"892","2004-11-12",47.3,41.33,179,1079,1,1259,0.142176330420969,0.857029388403495
"893","2004-11-19",48.9,42.29,186,1080,2,1268,0.146687697160883,0.851735015772871
"894","2004-11-24",49.14,42.62,177,1072,2,1251,0.141486810551559,0.85691446842526
"895","2004-12-03",42.56,38.57,173,1070,2,1245,0.138955823293173,0.859437751004016
"896","2004-12-10",40.71,37.24,178,1070,2,1250,0.1424,0.856
"897","2004-12-17",46.31,43.06,182,1050,2,1234,0.147487844408428,0.850891410048622
"898","2004-12-23",42.19,40.29,184,1070,3,1257,0.146380270485282,0.851233094669849
"899","2004-12-31",NA,40.38,183,1058,2,1243,0.14722445695897,0.851166532582462
"900","2005-01-07",45.32,43.28,177,1063,2,1242,0.142512077294686,0.855877616747182
"901","2005-01-14",48.41,45.26,172,1084,2,1258,0.136724960254372,0.861685214626391
"902","2005-01-21",48.31,45.88,177,1084,2,1263,0.140142517814727,0.858273950910531
"903","2005-01-28",47.15,44.75,185,1069,2,1256,0.147292993630573,0.851114649681529
"904","2005-02-04",46.45,43.26,187,1059,2,1248,0.149839743589744,0.848557692307692
"905","2005-02-11",47.15,44.41,193,1086,1,1280,0.15078125,0.8484375
"906","2005-02-18",48.45,45.86,197,1096,2,1295,0.152123552123552,0.846332046332046
"907","2005-02-25",52.2,50.05,189,1090,2,1281,0.147540983606557,0.850897736143638
"908","2005-03-04",53.7,52.1,198,1090,2,1290,0.153488372093023,0.844961240310078
"909","2005-03-11",54.4,53.15,189,1091,2,1282,0.147425897035881,0.851014040561622
"910","2005-03-18",56.8,55.97,180,1139,1,1320,0.136363636363636,0.862878787878788
"911","2005-03-24",49.7,52.35,178,1152,1,1331,0.133734034560481,0.865514650638618
"912","2005-04-01",57.26,54.14,171,1157,1,1329,0.128668171557562,0.870579382994733
"913","2005-04-08",53.46,51.83,170,1157,0,1327,0.12810851544838,0.87189148455162
"914","2005-04-15",50.61,49.52,173,1175,0,1348,0.128338278931751,0.871661721068249
"915","2005-04-22",54.16,53.51,173,1170,0,1343,0.128816083395383,0.871183916604617
"916","2005-04-29",49.2,50.61,169,1156,0,1325,0.127547169811321,0.872452830188679
"917","2005-05-06",51.3,49.7,155,1169,0,1324,0.117069486404834,0.882930513595166
"918","2005-05-13",48.65,46.85,150,1158,0,1308,0.114678899082569,0.885321100917431
"919","2005-05-20",47.25,46.91,146,1169,0,1315,0.111026615969582,0.888973384030418
"920","2005-05-27",51.65,49.42,148,1183,0,1331,0.111194590533434,0.888805409466567
"921","2005-06-03",55.08,51.9,146,1206,1,1353,0.107908351810791,0.891352549889135
"922","2005-06-10",53.55,51.98,141,1196,2,1339,0.105302464525766,0.893203883495146
"923","2005-06-17",58.4,56.92,146,1210,2,1358,0.107511045655376,0.891016200294551
"924","2005-06-24",59.63,57.21,149,1219,2,1370,0.108759124087591,0.88978102189781
"925","2005-07-01",59.11,56.41,157,1211,2,1370,0.114598540145985,0.883941605839416
"926","2005-07-08",59.71,59,157,1235,2,1394,0.112625538020086,0.885939741750359
"927","2005-07-15",58.36,56.98,168,1234,2,1404,0.11965811965812,0.878917378917379
"928","2005-07-22",57.75,56.98,181,1228,1,1410,0.128368794326241,0.870921985815603
"929","2005-07-29",60.71,59.77,189,1221,2,1412,0.13385269121813,0.864730878186969
"930","2005-08-05",62.44,60.73,199,1235,2,1436,0.13857938718663,0.860027855153203
"931","2005-08-12",66.71,67.26,197,1230,2,1429,0.137858642407278,0.86074177746676
"932","2005-08-19",65.51,64.21,207,1221,5,1433,0.144452198185625,0.852058618283322
"933","2005-08-26",66.05,66.23,220,1220,4,1444,0.152354570637119,0.844875346260388
"934","2005-09-02",66.91,65.95,223,1219,5,1447,0.15411195577056,0.842432619212163
"935","2005-09-09",64.21,62.62,215,1221,5,1441,0.149201943095073,0.847328244274809
"936","2005-09-16",62.91,60.48,202,1230,4,1436,0.14066852367688,0.856545961002786
"937","2005-09-23",64.67,62.17,205,1239,7,1451,0.141281874569263,0.853893866299104
"938","2005-09-30",66.21,61.7,203,1273,7,1483,0.136884693189481,0.858395144976399
"939","2005-10-07",61.81,57.29,209,1264,8,1481,0.141120864280891,0.853477380148548
"940","2005-10-14",62.61,58.45,215,1262,5,1482,0.145074224021592,0.851551956815115
"941","2005-10-21",61.05,56.94,216,1253,5,1474,0.146540027137042,0.850067842605156
"942","2005-10-28",61.3,59.47,227,1247,6,1480,0.153378378378378,0.842567567567568
"943","2005-11-04",60.6,60.48,231,1260,5,1496,0.154411764705882,0.842245989304813
"944","2005-11-11",57.45,54.3,241,1232,6,1479,0.162947937795808,0.832995267072346
"945","2005-11-18",56.3,52.84,265,1209,4,1478,0.179296346414073,0.817997293640054
"946","2005-11-23",58.35,53.73,275,1212,4,1491,0.184439973172368,0.812877263581489
"947","2005-12-02",59.31,54.91,264,1192,4,1460,0.180821917808219,0.816438356164384
"948","2005-12-09",59.41,57.18,257,1222,4,1483,0.17329737019555,0.824005394470668
"949","2005-12-16",58.01,58.11,237,1222,4,1463,0.161995898838004,0.83526999316473
"950","2005-12-22",58.08,57.3,243,1230,2,1475,0.164745762711864,0.833898305084746
"951","2005-12-30",61.06,58.34,235,1234,2,1471,0.159755268524813,0.838885112168593
"952","2006-01-06",64.21,62.43,243,1219,2,1464,0.165983606557377,0.832650273224044
"953","2006-01-13",63.86,61.58,241,1224,2,1467,0.16428084526244,0.834355828220859
"954","2006-01-20",68.16,64.92,247,1222,3,1472,0.167798913043478,0.830163043478261
"955","2006-01-27",67.81,64.95,237,1247,3,1487,0.159381304640215,0.838601210490921
"956","2006-02-03",65.41,62.54,197,1313,3,1513,0.130204890945142,0.867812293456709
"957","2006-02-10",62.01,59.66,206,1323,3,1532,0.134464751958225,0.863577023498695
"958","2006-02-17",59.76,58.34,215,1327,3,1545,0.13915857605178,0.858899676375405
"959","2006-02-24",61.46,60.13,219,1322,2,1543,0.141931302657161,0.856772521062865
"960","2006-03-03",63.61,62.69,226,1304,1,1531,0.147615937295885,0.851730894839974
"961","2006-03-10",59.91,59.04,238,1292,2,1532,0.155352480417755,0.843342036553525
"962","2006-03-17",62.81,63.54,249,1295,2,1546,0.161060802069858,0.83764553686934
"963","2006-03-24",63.9,62.78,255,1314,2,1571,0.162316995544239,0.836409929980904
"964","2006-03-31",66.25,66.06,253,1321,2,1576,0.160532994923858,0.838197969543147
"965","2006-04-07",67.02,67.11,264,1313,2,1579,0.167194426852438,0.83153894870171
"966","2006-04-13",69.53,69.39,259,1349,2,1610,0.160869565217391,0.837888198757764
"967","2006-04-21",73.73,73.94,259,1331,1,1591,0.162790697674419,0.836580766813325
"968","2006-04-28",71.8,72.15,254,1353,1,1608,0.157960199004975,0.841417910447761
"969","2006-05-05",70.09,71.22,259,1365,1,1625,0.159384615384615,0.84
"970","2006-05-12",71.87,71.3,259,1367,1,1627,0.159188690842041,0.84019668100799
"971","2006-05-19",68.44,66.93,260,1378,1,1639,0.158633312995729,0.840756558877364
"972","2006-05-26",71.35,69.88,265,1381,3,1649,0.160703456640388,0.837477258944815
"973","2006-06-02",72.73,68.42,265,1389,3,1657,0.15992757996379,0.83826191913096
"974","2006-06-09",71.62,69.13,281,1376,4,1661,0.169175195665262,0.828416616496087
"975","2006-06-16",69.75,65.01,285,1383,4,1672,0.170454545454545,0.827153110047847
"976","2006-06-23",70.5,69.91,294,1371,4,1669,0.176153385260635,0.821449970041941
"977","2006-06-30",73.94,73.2,302,1359,5,1666,0.181272509003601,0.815726290516207
"978","2006-07-07",73.76,74.14,295,1359,5,1659,0.177817962628089,0.819168173598553
"979","2006-07-14",76.8,76.13,296,1368,4,1668,0.177458033573142,0.820143884892086
"980","2006-07-21",73.52,72.96,299,1381,3,1683,0.177658942364825,0.820558526440879
"981","2006-07-28",73.3,73.95,302,1408,4,1714,0.176196032672112,0.82147024504084
"982","2006-08-04",74.78,76.53,305,1396,4,1705,0.178885630498534,0.818768328445748
"983","2006-08-11",74.38,75.19,315,1409,4,1728,0.182291666666667,0.815393518518519
"984","2006-08-18",70.93,71.3,330,1427,5,1762,0.187287173666288,0.809875141884223
"985","2006-08-25",72.13,72.58,315,1436,5,1756,0.179384965831435,0.817767653758542
"986","2006-09-01",69.24,70.49,311,1416,5,1732,0.179561200923788,0.817551963048499
"987","2006-09-08",66.3,64.3,310,1413,5,1728,0.179398148148148,0.817708333333333
"988","2006-09-15",63.3,60.23,310,1422,5,1737,0.178468624064479,0.818652849740933
"989","2006-09-22",59.79,58.81,299,1450,5,1754,0.170467502850627,0.826681870011403
"990","2006-09-29",62.9,59.09,295,1445,4,1744,0.169151376146789,0.82855504587156
"991","2006-10-06",59.68,56.9,288,1432,4,1724,0.167053364269142,0.830626450116009
"992","2006-10-13",58.69,58.97,284,1439,5,1728,0.164351851851852,0.83275462962963
"993","2006-10-20",57.35,57.94,291,1442,6,1739,0.167337550316274,0.829212190914319
"994","2006-10-27",60.75,57.99,289,1450,5,1744,0.165711009174312,0.831422018348624
"995","2006-11-03",59.13,56.55,291,1443,5,1739,0.167337550316274,0.829787234042553
"996","2006-11-10",59.66,59.18,273,1415,5,1693,0.161252215002953,0.83579444772593
"997","2006-11-17",55.9,57.01,289,1402,5,1696,0.170400943396226,0.826650943396227
"998","2006-11-22",57.28,58.66,297,1395,5,1697,0.175014731879788,0.82203889216264
"999","2006-12-01",63.43,64.74,289,1423,5,1717,0.168316831683168,0.828771112405358
"1000","2006-12-08",62.06,63.67,282,1437,5,1724,0.163573085846868,0.833526682134571
"1001","2006-12-15",63.4,62.91,278,1433,5,1716,0.162004662004662,0.835081585081585
"1002","2006-12-22",61.81,61.92,279,1438,6,1723,0.161926871735345,0.834590829947766
"1003","2006-12-29",60.85,58.96,278,1425,7,1710,0.162573099415205,0.833333333333333
"1004","2007-01-05",56.29,52.82,279,1411,5,1695,0.164601769911504,0.832448377581121
"1005","2007-01-12",52.96,49.95,269,1444,4,1717,0.156668608037274,0.841001747233547
"1006","2007-01-19",51.98,52.29,275,1466,4,1745,0.157593123209169,0.840114613180516
"1007","2007-01-26",55.38,55.29,255,1440,4,1699,0.150088287227781,0.847557386698058
"1008","2007-02-02",59.01,56.93,264,1446,4,1714,0.154025670945158,0.843640606767795
"1009","2007-02-09",59.86,57.21,254,1473,4,1731,0.146735990756788,0.850953206239168
"1010","2007-02-16",59.38,56.78,267,1473,6,1746,0.152920962199313,0.843642611683849
"1011","2007-02-23",60.28,60.38,278,1472,4,1754,0.158494868871152,0.839224629418472
"1012","2007-03-02",61.58,61.92,290,1458,4,1752,0.165525114155251,0.832191780821918
"1013","2007-03-09",60.06,60.25,287,1465,5,1757,0.163346613545817,0.833807626636312
"1014","2007-03-16",57.06,60.93,282,1453,5,1740,0.162068965517241,0.835057471264368
"1015","2007-03-23",61.07,63.1,281,1459,5,1745,0.161031518624642,0.836103151862464
"1016","2007-03-30",65.94,68.47,271,1472,6,1749,0.15494568324757,0.841623785020012
"1017","2007-04-13",63.63,68.78,282,1472,4,1758,0.160409556313993,0.837315130830489
"1018","2007-04-20",63.56,66.34,292,1473,4,1769,0.165065008479367,0.832673827020916
"1019","2007-04-27",66.45,67.28,283,1460,4,1747,0.161991986262164,0.835718374356039
"1020","2007-05-04",61.89,65.14,282,1462,3,1747,0.161419576416714,0.836863194046938
"1021","2007-05-11",62.35,65.18,282,1456,2,1740,0.162068965517241,0.836781609195402
"1022","2007-05-18",64.93,69.26,276,1466,2,1744,0.158256880733945,0.840596330275229
"1023","2007-05-25",64.59,70.72,287,1471,2,1760,0.163068181818182,0.835795454545455
"1024","2007-06-01",65.09,68.65,288,1484,2,1774,0.162344983089064,0.836527621195039
"1025","2007-06-08",64.78,70.04,291,1465,4,1760,0.165340909090909,0.832386363636364
"1026","2007-06-15",68.04,71.63,285,1484,4,1773,0.160744500846024,0.836999435984208
"1027","2007-06-22",68.85,72.04,271,1495,5,1771,0.153020892151327,0.844155844155844
"1028","2007-06-29",70.47,72.22,281,1489,5,1775,0.15830985915493,0.83887323943662
"1029","2007-07-06",72.8,76.58,274,1473,5,1752,0.156392694063927,0.840753424657534
"1030","2007-07-13",73.89,78.12,284,1501,6,1791,0.15857063093244,0.838079285315466
"1031","2007-07-20",75.53,79.09,287,1497,6,1790,0.160335195530726,0.836312849162011
"1032","2007-07-27",77.03,76.58,296,1474,5,1775,0.166760563380282,0.830422535211268
"1033","2007-08-03",75.41,75.36,306,1470,5,1781,0.171813587871982,0.825379000561482
"1034","2007-08-10",71.49,69.57,305,1487,6,1798,0.169632925472748,0.827030033370412
"1035","2007-08-17",71.9,69.8,309,1480,6,1795,0.172144846796657,0.824512534818942
"1036","2007-08-24",71.17,69.49,310,1500,6,1816,0.170704845814978,0.825991189427313
"1037","2007-08-31",73.98,72.29,300,1523,6,1829,0.164024056861673,0.832695462001094
"1038","2007-09-07",76.7,75.08,294,1514,6,1814,0.162072767364939,0.834619625137817
"1039","2007-09-14",79.14,78.27,298,1483,6,1787,0.166759932848349,0.82988248461108
"1040","2007-09-21",83.38,78.91,305,1458,6,1769,0.172413793103448,0.824194460146976
"1041","2007-09-28",81.64,80.97,311,1443,6,1760,0.176704545454545,0.819886363636364
"1042","2007-10-05",81.2,79.05,318,1431,6,1755,0.181196581196581,0.815384615384615
"1043","2007-10-12",83.73,80.82,319,1442,6,1767,0.180531975099038,0.816072439162422
"1044","2007-10-19",88.58,84.25,320,1438,6,1764,0.18140589569161,0.815192743764172
"1045","2007-10-26",91.73,84.71,326,1428,6,1760,0.185227272727273,0.811363636363636
"1046","2007-11-02",95.81,92.11,335,1455,5,1795,0.186629526462396,0.81058495821727
"1047","2007-11-09",96.36,92.32,337,1459,5,1801,0.187118267629095,0.810105496946141
"1048","2007-11-16",94.81,91.99,337,1455,5,1797,0.187534780189204,0.809682804674457
"1049","2007-11-21",98.57,94.97,343,1424,6,1773,0.193457416807671,0.803158488437676
"1050","2007-11-30",88.6,88.71,354,1463,6,1823,0.194185408667032,0.802523313219967
"1051","2007-12-07",88.23,88.46,340,1482,6,1828,0.185995623632385,0.810722100656455
"1052","2007-12-14",91.31,91.86,342,1477,5,1824,0.1875,0.809758771929825
"1053","2007-12-21",93.19,91.03,343,1461,5,1809,0.189607517965727,0.807628524046435
"1054","2007-12-28",96.03,95.92,325,1452,5,1782,0.182379349046016,0.814814814814815
"1055","2008-01-04",97.9,96.87,316,1450,8,1774,0.178128523111612,0.817361894024803
"1056","2008-01-11",92.74,91.86,327,1409,8,1744,0.1875,0.807912844036697
"1057","2008-01-18",90.55,89.66,323,1401,8,1732,0.1864896073903,0.808891454965358
"1058","2008-01-25",90.37,90.96,318,1422,7,1747,0.182026330852891,0.813966800228964
"1059","2008-02-01",89.03,91.41,324,1432,7,1763,0.183777651730006,0.812251843448667
"1060","2008-02-08",91.77,91.45,324,1424,7,1755,0.184615384615385,0.811396011396011
"1061","2008-02-15",95.57,96.96,339,1428,6,1773,0.191201353637902,0.805414551607445
"1062","2008-02-22",99.03,96.07,333,1430,8,1771,0.188029361942405,0.807453416149068
"1063","2008-02-29",101.78,100.9,337,1418,8,1763,0.191151446398185,0.804310833806012
"1064","2008-03-07",105.12,104.66,337,1456,9,1802,0.187014428412875,0.807991120976693
"1065","2008-03-14",110.03,109.16,343,1441,8,1792,0.19140625,0.804129464285714
"1066","2008-03-28",105.59,102.68,350,1447,11,1808,0.19358407079646,0.80033185840708
"1067","2008-04-04",106.09,102.21,362,1458,10,1830,0.197814207650273,0.79672131147541
"1068","2008-04-11",110.14,107.15,355,1451,9,1815,0.195592286501377,0.799449035812672
"1069","2008-04-18",116.56,110.67,355,1461,11,1827,0.194307608100712,0.799671592775041
"1070","2008-04-25",119.64,116.62,360,1473,9,1842,0.195439739413681,0.799674267100977
"1071","2008-05-02",116.36,111.92,357,1473,9,1839,0.194127243066884,0.800978792822186
"1072","2008-05-09",125.94,123.54,361,1475,10,1846,0.195557963163597,0.799024918743229
"1073","2008-05-16",126.5,122.98,381,1471,10,1862,0.204618689581096,0.790010741138561
"1074","2008-05-23",131.58,129.72,386,1493,10,1889,0.204340921122287,0.790365272631022
"1075","2008-05-30",127.35,127.85,390,1479,8,1877,0.207778369738945,0.787959509856154
"1076","2008-06-06",138.51,132.81,385,1493,8,1886,0.204135737009544,0.791622481442206
"1077","2008-06-13",134.84,134.29,389,1504,8,1901,0.204629142556549,0.791162546028406
"1078","2008-06-20",134.78,134.28,384,1514,8,1906,0.201469045120672,0.794333683105981
"1079","2008-06-27",139.69,139.38,375,1530,8,1913,0.196027182435964,0.799790904338735
"1080","2008-07-11",144.96,143.68,370,1544,8,1922,0.192507804370447,0.803329864724246
"1081","2008-07-18",128.94,129.34,385,1534,9,1928,0.199688796680498,0.795643153526971
"1082","2008-07-25",122.59,124.7,393,1555,9,1957,0.200817577925396,0.794583546244251
"1083","2008-08-01",125.03,124.16,392,1550,9,1951,0.200922603792927,0.79446437724244
"1084","2008-08-08",115.42,113.03,387,1571,9,1967,0.196746314184037,0.798678190137265
"1085","2008-08-15",113.46,108.8,395,1586,9,1990,0.198492462311558,0.796984924623116
"1086","2008-08-22",114.48,113.99,395,1594,9,1998,0.197697697697698,0.797797797797798
"1087","2008-08-29",115.55,113.49,416,1606,9,2031,0.204825209256524,0.790743476120138
"1088","2008-09-05",106.47,102.51,416,1586,11,2013,0.206656731246895,0.787878787878788
"1089","2008-09-12",101.19,94.37,413,1606,12,2031,0.203348104382078,0.790743476120138
"1090","2008-09-19",104.05,93.46,417,1589,12,2018,0.206640237859267,0.787413280475719
"1091","2008-09-26",106.77,100.88,423,1559,13,1995,0.21203007518797,0.781453634085213
"1092","2008-10-03",93.91,88.95,422,1544,13,1979,0.213239009600809,0.780192016169783
"1093","2008-10-10",77.44,74.58,429,1548,13,1990,0.215577889447236,0.777889447236181
"1094","2008-10-17",71.9,66.05,428,1537,11,1976,0.216599190283401,0.777834008097166
"1095","2008-10-24",63.34,60.57,423,1529,12,1964,0.215376782077393,0.778513238289206
"1096","2008-10-31",68.1,60,408,1552,11,1971,0.207001522070015,0.787417554540842
"1097","2008-11-07",61.06,56.84,442,1539,11,1992,0.221887550200803,0.772590361445783
"1098","2008-11-14",57.18,50.7,429,1498,14,1941,0.221020092735703,0.771767130345183
"1099","2008-11-21",49.22,44.91,419,1511,11,1941,0.215868109222051,0.778464708912932
"1100","2008-11-26",54.2,49.39,412,1443,11,1866,0.220793140407288,0.773311897106109
"1101","2008-12-05",41.01,37.04,413,1428,11,1852,0.223002159827214,0.771058315334773
"1102","2008-12-12",46.27,42.38,401,1379,10,1790,0.224022346368715,0.770391061452514
"1103","2008-12-19",33.17,39.52,387,1366,11,1764,0.219387755102041,0.77437641723356
"1104","2008-12-26",37.58,33.73,364,1347,10,1721,0.21150493898896,0.782684485764091
"1105","2009-01-02",46.17,42.94,346,1267,10,1623,0.213185459026494,0.780653111521873
"1106","2009-01-09",40.69,42.34,341,1239,9,1589,0.214600377595972,0.779735682819383
"1107","2009-01-16",35.38,43.42,324,1235,9,1568,0.206632653061225,0.787627551020408
"1108","2009-01-23",45.12,43.13,318,1185,12,1515,0.20990099009901,0.782178217821782
"1109","2009-01-30",41.73,44.17,309,1150,13,1472,0.20991847826087,0.78125
"1110","2009-02-06",40.24,44.49,283,1104,12,1399,0.20228734810579,0.789135096497498
"1111","2009-02-13",37.63,43.36,273,1054,12,1339,0.203883495145631,0.787154592979836
"1112","2009-02-20",39.35,42.19,269,1018,13,1300,0.206923076923077,0.783076923076923
"1113","2009-02-27",44.15,44.41,260,970,13,1243,0.209171359613837,0.780370072405471
"1114","2009-03-06",45.43,43.48,241,916,13,1170,0.205982905982906,0.782905982905983
"1115","2009-03-13",46.22,44.97,228,884,14,1126,0.202486678507993,0.785079928952043
"1116","2009-03-20",51.55,49.27,215,857,13,1085,0.19815668202765,0.789861751152074
"1117","2009-03-27",52.41,50.81,217,810,12,1039,0.208854667949952,0.779595765158807
"1118","2009-04-03",52.52,50.48,224,808,11,1043,0.214765100671141,0.774688398849473
"1119","2009-04-17",50.36,52.02,205,760,10,975,0.21025641025641,0.77948717948718
"1120","2009-04-24",50.65,50.29,202,742,11,955,0.21151832460733,0.77696335078534
"1121","2009-05-01",52.18,51.75,196,741,8,945,0.207407407407407,0.784126984126984
"1122","2009-05-08",58.58,56.02,190,730,8,928,0.204741379310345,0.786637931034483
"1123","2009-05-15",56.52,56.33,181,728,9,918,0.197167755991285,0.793028322440087
"1124","2009-05-22",61.15,58.7,180,711,9,900,0.2,0.79
"1125","2009-05-29",66.31,64.98,187,703,9,899,0.208008898776418,0.781979977753059
"1126","2009-06-05",68.43,67.77,179,700,8,887,0.201803833145434,0.789177001127396
"1127","2009-06-12",72.13,70.62,183,685,8,876,0.208904109589041,0.781963470319635
"1128","2009-06-19",69.6,70.48,196,692,11,899,0.218020022246941,0.769744160177976
"1129","2009-06-26",69.16,68.1,219,687,11,917,0.238822246455834,0.749182115594329
"1130","2009-07-02",66.68,65.74,229,688,11,928,0.24676724137931,0.741379310344828
"1131","2009-07-10",59.93,58.43,234,672,10,916,0.255458515283843,0.733624454148472
"1132","2009-07-17",63.56,63.54,244,665,11,920,0.265217391304348,0.722826086956522
"1133","2009-07-24",66.96,68.82,257,675,11,943,0.27253446447508,0.715800636267232
"1134","2009-07-31",69.26,70.08,261,677,10,948,0.275316455696203,0.714135021097046
"1135","2009-08-07",70.97,74.21,277,681,8,966,0.286749482401656,0.704968944099379
"1136","2009-08-14",67.51,71.33,272,688,8,968,0.28099173553719,0.710743801652893
"1137","2009-08-21",73.12,73.71,280,695,10,985,0.284263959390863,0.705583756345178
"1138","2009-08-28",72.72,72.8,286,699,14,999,0.286286286286286,0.6996996996997
"1139","2009-09-04",67.95,65.84,295,701,13,1009,0.292368681863231,0.694747274529237
"1140","2009-09-11",69.34,68.76,288,699,12,999,0.288288288288288,0.6996996996997
"1141","2009-09-18",71.95,70.72,293,705,12,1010,0.29009900990099,0.698019801980198
"1142","2009-09-25",65.91,64.6,297,710,10,1017,0.292035398230089,0.698131760078663
"1143","2009-10-02",69.8,66.5,303,712,9,1024,0.2958984375,0.6953125
"1144","2009-10-09",71.75,69.45,305,726,10,1041,0.292987512007685,0.697406340057637
"1145","2009-10-16",78.54,74.58,309,721,10,1040,0.297115384615385,0.693269230769231
"1146","2009-10-23",80.11,77.72,312,725,11,1048,0.297709923664122,0.691793893129771
"1147","2009-10-30",77.04,74.91,330,728,11,1069,0.308699719363892,0.681010289990646
"1148","2009-11-06",77.4,75.51,332,734,12,1078,0.307977736549165,0.680890538033395
"1149","2009-11-13",76.34,74.81,361,728,12,1101,0.327883742052679,0.661217075386013
"1150","2009-11-20",76.83,75.61,375,726,12,1113,0.336927223719677,0.652291105121294
"1151","2009-11-25",77.25,76.57,379,748,10,1137,0.333333333333333,0.657871591908531
"1152","2009-12-04",75.41,77.74,383,748,10,1141,0.33567046450482,0.655565293602104
"1153","2009-12-11",69.86,70.07,393,757,11,1161,0.338501291989664,0.652024117140396
"1154","2009-12-18",73.3,71.87,409,773,11,1193,0.342833193629505,0.647946353730092
"1155","2009-12-23",76.03,73.87,416,751,11,1178,0.353140916808149,0.637521222410866
"1156","2009-12-31",79.39,77.91,418,759,12,1189,0.351555929352397,0.638351555929352
"1157","2010-01-08",82.74,80.06,427,781,12,1220,0.35,0.64016393442623
"1158","2010-01-15",77.96,76.85,425,811,12,1248,0.340544871794872,0.649839743589744
"1159","2010-01-22",74.25,72.73,437,833,12,1282,0.340873634945398,0.649765990639626
"1160","2010-01-29",72.85,71.2,444,861,12,1317,0.337129840546697,0.65375854214123
"1161","2010-02-05",71.15,70.11,445,878,12,1335,0.333333333333333,0.657677902621723
"1162","2010-02-12",74.11,71.49,443,891,12,1346,0.329123328380386,0.661961367013373
"1163","2010-02-19",79.77,76.88,440,893,12,1345,0.327137546468402,0.663940520446097
"1164","2010-02-26",79.72,76.36,456,905,12,1373,0.332119446467589,0.659140568099053
"1165","2010-03-05",81.5,79.2,456,926,14,1396,0.326647564469914,0.663323782234957
"1166","2010-03-12",81.26,79.38,466,927,14,1407,0.331201137171286,0.658848614072495
"1167","2010-03-19",80.58,78.37,474,939,14,1427,0.332165381920112,0.65802382620883
"1168","2010-03-26",79.75,77.98,489,941,14,1444,0.338642659279778,0.651662049861496
"1169","2010-04-01",84.53,82.63,502,949,14,1465,0.342662116040956,0.64778156996587
"1170","2010-04-09",84.6,82.77,505,959,12,1476,0.342140921409214,0.649728997289973
"1171","2010-04-16",82.97,84.81,506,973,12,1491,0.339369550637156,0.652582159624413
"1172","2010-04-23",84.34,86.09,514,956,12,1482,0.346828609986505,0.645074224021592
"1173","2010-04-30",86.07,86.19,513,958,12,1483,0.345920431557653,0.645987862440998
"1174","2010-05-07",75.1,76.48,528,953,11,1492,0.353887399463807,0.638739946380697
"1175","2010-05-14",71.61,76.43,544,951,11,1506,0.361221779548473,0.631474103585657
"1176","2010-05-21",68.03,70.45,538,969,11,1518,0.354413702239789,0.638339920948617
"1177","2010-05-28",74,73,555,967,13,1535,0.361563517915309,0.629967426710098
"1178","2010-06-04",71.43,71.84,545,947,14,1506,0.361885790172643,0.628818061088977
"1179","2010-06-11",73.89,73.28,561,954,12,1527,0.367387033398821,0.62475442043222
"1180","2010-06-18",77.18,77.05,574,953,12,1539,0.372969460688759,0.619233268356075
"1181","2010-06-25",78.45,76.21,583,958,11,1552,0.375644329896907,0.617268041237113
"1182","2010-07-02",72.06,71.75,587,960,10,1557,0.377007064868337,0.616570327552987
"1183","2010-07-09",76.08,75.2,592,964,11,1567,0.377791959157626,0.615188257817486
"1184","2010-07-16",75.96,75.55,580,979,12,1571,0.369191597708466,0.623169955442393
"1185","2010-07-23",78.68,77.27,591,982,12,1585,0.372870662460568,0.619558359621451
"1186","2010-07-30",78.85,77.5,603,972,11,1586,0.380201765447667,0.612862547288777
"1187","2010-08-06",80.67,81.28,611,983,11,1605,0.380685358255452,0.612461059190031
"1188","2010-08-13",75.39,75.14,636,992,12,1640,0.387804878048781,0.604878048780488
"1189","2010-08-20",73.45,73.48,655,985,11,1651,0.396729254996972,0.596608116293156
"1190","2010-08-27",75.17,75.16,672,973,11,1656,0.405797101449275,0.58756038647343
"1191","2010-09-03",74.52,75.03,665,977,11,1653,0.402298850574713,0.591046581972172
"1192","2010-09-10",76.4,77.54,663,980,11,1654,0.400846432889964,0.592503022974607
"1193","2010-09-17",73.63,77.43,670,982,9,1661,0.403371462974112,0.591210114388922
"1194","2010-09-24",74.63,78.73,673,967,10,1650,0.407878787878788,0.586060606060606
"1195","2010-10-01",81.57,82.69,687,962,10,1659,0.414104882459313,0.579867389993972
"1196","2010-10-08",82.66,83.88,690,971,10,1671,0.412926391382406,0.581089168162777
"1197","2010-10-15",81.23,81.94,695,966,9,1670,0.416167664670659,0.578443113772455
"1198","2010-10-22",81.15,80.75,695,965,9,1669,0.416417016177352,0.578190533253445
"1199","2010-10-29",81.45,82.47,696,967,9,1672,0.416267942583732,0.578349282296651
"1200","2010-11-05",86.85,87.05,718,955,10,1683,0.426619132501485,0.567439096850862
"1201","2010-11-12",84.89,86.07,720,955,10,1685,0.427299703264095,0.566765578635015
"1202","2010-11-19",81.65,83.17,731,936,10,1677,0.435897435897436,0.558139534883721
"1203","2010-11-24",83.21,84.53,724,953,10,1687,0.429164196799052,0.564908120924718
"1204","2010-12-03",89.18,90.65,742,961,10,1713,0.433158201984822,0.561004086398132
"1205","2010-12-10",87.81,89.54,763,948,12,1723,0.442832269297737,0.550203134068485
"1206","2010-12-17",88.02,91.11,756,941,12,1709,0.442363955529549,0.55061439438268
"1207","2010-12-22",89.83,93.55,771,931,12,1714,0.449824970828471,0.543173862310385
"1208","2010-12-30",89.85,92.5,765,919,10,1694,0.45159386068477,0.542502951593861
"1209","2011-01-07",88.07,94.25,777,914,9,1700,0.457058823529412,0.537647058823529
"1210","2011-01-14",91.53,97.86,789,902,9,1700,0.464117647058824,0.530588235294118
"1211","2011-01-21",88.22,96.84,798,906,9,1713,0.46584938704028,0.528896672504378
"1212","2011-01-28",88.15,97.06,809,913,10,1732,0.467090069284065,0.527136258660508
"1213","2011-02-04",87.87,99.43,818,911,10,1739,0.470385278895917,0.523864289821737
"1214","2011-02-11",84.39,99.93,805,906,10,1721,0.467751307379431,0.52643811737362
"1215","2011-02-18",85.03,102.2,798,905,10,1713,0.46584938704028,0.528312901342674
"1216","2011-02-25",96.52,111.47,783,906,10,1699,0.460859329017069,0.533254855797528
"1217","2011-03-04",104.34,115.71,801,899,7,1707,0.469244288224956,0.526654950205038
"1218","2011-03-11",101.14,114.07,827,882,6,1715,0.482215743440233,0.514285714285714
"1219","2011-03-18",101.06,114.13,839,875,6,1720,0.487790697674419,0.508720930232558
"1220","2011-03-25",104.89,115.45,851,880,7,1738,0.489643268124281,0.506329113924051
"1221","2011-04-01",107.55,118.63,877,891,8,1776,0.493806306306306,0.501689189189189
"1222","2011-04-08",112.27,126.3,886,889,7,1782,0.497194163860831,0.498877665544332
"1223","2011-04-15",109.17,124.63,880,885,7,1772,0.496613995485327,0.499435665914221
"1224","2011-04-21",111.72,123.64,913,878,9,1800,0.507222222222222,0.487777777777778
"1225","2011-04-29",113.39,NA,926,882,10,1818,0.509350935093509,0.485148514851485
"1226","2011-05-06",96.87,113.69,934,890,12,1836,0.508714596949891,0.484749455337691
"1227","2011-05-13",99.21,113.08,947,874,9,1830,0.517486338797814,0.477595628415301
"1228","2011-05-20",99.15,111.25,954,866,10,1830,0.521311475409836,0.473224043715847
"1229","2011-05-27",100.58,114.85,958,881,8,1847,0.518678938819708,0.476989713048186
"1230","2011-06-03",100.28,115.09,959,887,8,1854,0.517259978425027,0.478425026968716
"1231","2011-06-10",99.3,118.71,969,879,7,1855,0.522371967654987,0.473854447439353
"1232","2011-06-17",93.02,113.74,984,870,6,1860,0.529032258064516,0.467741935483871
"1233","2011-06-24",90.89,104.79,1003,873,6,1882,0.532943676939426,0.463868225292242
"1234","2011-07-01",94.81,109.82,1006,874,6,1886,0.533404029692471,0.463414634146342
"1235","2011-07-08",96.2,117.4,1007,873,7,1887,0.533651298357181,0.462639109697933
"1236","2011-07-15",97.24,118.06,1013,885,7,1905,0.531758530183727,0.464566929133858
"1237","2011-07-22",99.53,118.99,1021,889,6,1916,0.532881002087683,0.463987473903967
"1238","2011-07-29",95.68,115.93,1025,877,6,1908,0.537211740041929,0.459643605870021
"1239","2011-08-05",86.89,106.92,1031,883,6,1920,0.536979166666667,0.459895833333333
"1240","2011-08-12",85.19,108.17,1055,896,8,1959,0.538540071465033,0.457376212353241
"1241","2011-08-19",82.33,109.37,1066,900,8,1974,0.540020263424519,0.455927051671733
"1242","2011-08-26",85.37,112.29,1069,898,8,1975,0.54126582278481,0.454683544303798
"1243","2011-09-02",86.45,115.92,1064,895,9,1968,0.540650406504065,0.454776422764228
"1244","2011-09-09",87.24,115.1,1057,892,9,1958,0.539836567926456,0.455566905005107
"1245","2011-09-16",87.96,116.26,1062,912,11,1985,0.535012594458438,0.459445843828715
"1246","2011-09-23",79.58,109.17,1071,912,8,1991,0.537920642893019,0.458061275740834
"1247","2011-09-30",78.93,105.42,1060,923,7,1990,0.532663316582915,0.463819095477387
"1248","2011-10-07",82.7,106.56,1070,935,7,2012,0.531809145129225,0.464711729622266
"1249","2011-10-14",86.8,114.33,1080,936,7,2023,0.533860603064755,0.462679189322788
"1250","2011-10-21",87.19,111.6,1079,927,7,2013,0.536015896671634,0.460506706408346
"1251","2011-10-28",93.32,110.01,1078,934,9,2021,0.533399307273627,0.462147451756556
"1252","2011-11-04",94.26,112.22,1112,907,7,2026,0.548864758144126,0.447680157946693
"1253","2011-11-11",98.99,114.43,1133,877,6,2016,0.562003968253968,0.435019841269841
"1254","2011-11-18",97.67,107.82,1125,871,5,2001,0.562218890554723,0.43528235882059
"1255","2011-11-25",96.91,106.08,1130,865,5,2000,0.565,0.4325
"1256","2011-12-02",100.97,109.59,1132,856,5,1993,0.567987957852484,0.429503261414952
"1257","2011-12-09",99.4,107.91,1161,820,6,1987,0.584297936587821,0.412682435832914
"1258","2011-12-16",93.55,104,1196,818,5,2019,0.592372461614661,0.405151064883606
"1259","2011-12-22",99.42,108.98,1201,802,5,2008,0.598107569721116,0.399402390438247
"1260","2011-12-29",99.68,106.89,1193,809,5,2007,0.594419531639263,0.403089187842551
"1261","2012-01-06",101.56,111.96,1191,811,5,2007,0.593423019431988,0.404085700049826
"1262","2012-01-13",98.69,109.88,1191,791,5,1987,0.599396074484147,0.398087569199799
"1263","2012-01-20",98.15,108.5,1223,780,5,2008,0.60906374501992,0.388446215139442
"1264","2012-01-27",99.47,110.5,1225,777,6,2008,0.610059760956175,0.38695219123506
"1265","2012-02-03",97.8,112.56,1245,745,7,1997,0.623435152729094,0.373059589384076
"1266","2012-02-10",98.68,118.13,1263,720,6,1989,0.63499245852187,0.361990950226244
"1267","2012-02-17",103.27,120.69,1272,716,6,1994,0.637913741223671,0.359077231695085
"1268","2012-02-24",109.39,124.89,1265,710,6,1981,0.638566380615851,0.358404846037355
"1269","2012-03-02",106.68,125.93,1293,691,5,1989,0.650075414781297,0.347410759175465
"1270","2012-03-09",107.4,128.08,1296,670,7,1973,0.656867714140902,0.339584389254942
"1271","2012-03-16",107.03,125.09,1317,663,4,1984,0.663810483870968,0.334173387096774
"1272","2012-03-23",106.43,125.21,1313,652,3,1968,0.667174796747967,0.33130081300813
"1273","2012-03-30",103.03,123.41,1318,658,3,1979,0.665992925720061,0.332491157150076
"1274","2012-04-05",103.29,123.58,1329,647,3,1979,0.67155128852956,0.326932794340576
"1275","2012-04-13",102.84,120.62,1322,624,4,1950,0.677948717948718,0.32
"1276","2012-04-20",103.58,118.08,1337,631,4,1972,0.677991886409736,0.319979716024341
"1277","2012-04-27",104.86,119.3,1328,613,4,1945,0.682776349614396,0.315167095115681
"1278","2012-05-04",98.49,111.66,1355,606,4,1965,0.689567430025445,0.308396946564886
"1279","2012-05-11",96.03,112.5,1372,598,4,1974,0.695035460992908,0.302938196555218
"1280","2012-05-18",91.51,108.03,1382,600,4,1986,0.695871097683787,0.302114803625378
"1281","2012-05-25",90.64,107.86,1383,594,6,1983,0.697428139183056,0.299546142208775
"1282","2012-06-01",83.17,98.63,1386,588,6,1980,0.7,0.296969696969697
"1283","2012-06-08",84.08,97.57,1414,565,5,1984,0.712701612903226,0.284778225806452
"1284","2012-06-15",84.03,97.13,1405,562,4,1971,0.712836123795028,0.285134449518011
"1285","2012-06-22",79.33,89.22,1421,541,4,1966,0.722787385554425,0.275178026449644
"1286","2012-06-29",85.04,94.17,1421,534,4,1959,0.725370086778969,0.272588055130168
"1287","2012-07-06",84.37,98.5,1419,542,4,1965,0.722137404580153,0.275826972010178
"1288","2012-07-13",87.15,101.91,1427,522,4,1953,0.730670762928828,0.267281105990783
"1289","2012-07-20",91.56,106.98,1414,518,3,1935,0.730749354005168,0.267700258397933
"1290","2012-07-27",90.13,106.3,1416,505,3,1924,0.735966735966736,0.262474012474013
"1291","2012-08-03",91.4,109.57,1429,498,3,1930,0.740414507772021,0.258031088082902
"1292","2012-08-10",92.94,113.13,1432,495,4,1931,0.741584671154842,0.256343863283273
"1293","2012-08-17",96,115.2,1425,484,5,1914,0.744514106583072,0.252873563218391
"1294","2012-08-24",95.78,115.76,1408,486,4,1898,0.741833508956797,0.256059009483667
"1295","2012-08-31",96.47,113.93,1419,473,2,1894,0.749208025343189,0.24973600844773
"1296","2012-09-07",96.41,113.64,1409,452,3,1864,0.755901287553648,0.242489270386266
"1297","2012-09-14",98.94,117.48,1413,448,3,1864,0.758047210300429,0.240343347639485
"1298","2012-09-21",92.64,111.27,1402,454,3,1859,0.754168908015062,0.244217321140398
"1299","2012-09-28",92.18,111.36,1410,435,3,1848,0.762987012987013,0.23538961038961
"1300","2012-10-05",89.87,112.17,1398,437,2,1837,0.761023407729995,0.237887860642352
"1301","2012-10-12",91.83,115.17,1411,422,2,1835,0.768937329700273,0.229972752043597
"1302","2012-10-19",90,111.89,1410,427,2,1839,0.766721044045677,0.232191408374116
"1303","2012-10-26",85.84,108.9,1408,416,2,1826,0.771084337349398,0.227820372398686
"1304","2012-11-02",84.9,106.79,1373,424,3,1800,0.762777777777778,0.235555555555556
"1305","2012-11-09",86.08,108.61,1389,413,4,1806,0.769102990033223,0.228682170542636
"1306","2012-11-16",86.62,106.81,1390,417,2,1809,0.768380320619127,0.230514096185738
"1307","2012-11-21",87.08,110.81,1388,428,1,1817,0.763896532746285,0.235553109521189
"1308","2012-11-30",88.54,110.84,1386,424,1,1811,0.765323025952512,0.234124792932082
"1309","2012-12-07",85.45,107.16,1382,417,1,1800,0.767777777777778,0.231666666666667
"1310","2012-12-14",86.32,109.28,1381,416,2,1799,0.767648693718733,0.23123957754308
"1311","2012-12-21",88.2,109.13,1340,429,5,1774,0.755355129650507,0.241826381059752
"1312","2012-12-28",90.66,110.05,1327,431,5,1763,0.752694271128758,0.244469653998866
"1313","2013-01-04",93.12,112.58,1318,439,5,1762,0.748013620885358,0.249148694665153
"1314","2013-01-11",93.6,110.3,1323,434,4,1761,0.751277683134583,0.246450880181715
"1315","2013-01-18",95.61,111.71,1316,429,4,1749,0.75242995997713,0.245283018867925
"1316","2013-01-25",95.15,113.88,1315,434,4,1753,0.750142612664005,0.247575584711922
"1317","2013-02-01",97.46,115.55,1332,428,4,1764,0.755102040816327,0.242630385487528
"1318","2013-02-08",95.71,118.9,1330,425,4,1759,0.756111426947129,0.241614553723707
"1319","2013-02-15",95.95,117.4,1337,421,4,1762,0.758796821793417,0.238933030646992
"1320","2013-02-22",93.12,113.74,1329,428,4,1761,0.754684838160136,0.243043725156161
"1321","2013-03-01",90.71,110.14,1333,420,4,1757,0.758679567444508,0.239043824701195
"1322","2013-03-08",92.01,108.91,1341,407,4,1752,0.76541095890411,0.232305936073059
"1323","2013-03-15",93.49,109.32,1341,431,4,1776,0.755067567567568,0.24268018018018
"1324","2013-03-22",93.41,106.51,1324,418,4,1746,0.758304696449026,0.239404352806415
"1325","2013-03-28",97.24,108.46,1354,389,5,1748,0.774599542334096,0.22254004576659
"1326","2013-04-05",92.76,103.98,1357,375,6,1738,0.78078250863061,0.215765247410817
"1327","2013-04-12",91.23,100.58,1387,377,7,1771,0.78317334839074,0.2128740824393
"1328","2013-04-19",88.04,98.94,1371,379,8,1758,0.779863481228669,0.215585893060296
"1329","2013-04-26",92.63,102.39,1381,366,7,1754,0.787343215507412,0.20866590649943
"1330","2013-05-03",95.25,104.6,1403,354,7,1764,0.795351473922903,0.200680272108844
"1331","2013-05-10",95.81,101.31,1412,350,7,1769,0.798191068400226,0.197851893725269
"1332","2013-05-17",95.72,103.83,1408,354,7,1769,0.795929903900509,0.200113058224986
"1333","2013-05-24",93.84,101.24,1402,354,6,1762,0.795686719636776,0.200908059023837
"1334","2013-05-31",91.93,100.43,1410,354,7,1771,0.796160361377753,0.199887069452287
"1335","2013-06-07",96.11,104.07,1406,354,5,1765,0.796600566572238,0.20056657223796
"1336","2013-06-14",97.83,105.1,1413,353,5,1771,0.79785431959345,0.199322416713721
"1337","2013-06-21",93.81,100.36,1405,349,5,1759,0.79874928936896,0.198408186469585
"1338","2013-06-28",96.36,102.49,1390,353,5,1748,0.795194508009153,0.201945080091533
"1339","2013-07-03",101.92,106.12,1395,355,7,1757,0.793966989186113,0.202048947068867
"1340","2013-07-12",105.85,109.03,1391,362,6,1759,0.790790221716885,0.205798749289369
"1341","2013-07-19",108,109.34,1395,369,6,1770,0.788135593220339,0.208474576271186
"1342","2013-07-26",104.76,107.57,1401,369,6,1776,0.788851351351351,0.20777027027027
"1343","2013-08-02",106.94,109.63,1388,388,6,1782,0.778900112233446,0.217732884399551
"1344","2013-08-09",106.04,108.49,1385,386,7,1778,0.77896512935883,0.217097862767154
"1345","2013-08-16",107.58,111.82,1397,388,6,1791,0.78001116694584,0.216638749302066
"1346","2013-08-23",106.48,112.12,1382,387,7,1776,0.778153153153153,0.217905405405405
"1347","2013-08-30",107.98,115.97,1388,380,8,1776,0.781531531531532,0.213963963963964
"1348","2013-09-06",110.62,117.15,1365,394,8,1767,0.772495755517827,0.222976796830787
"1349","2013-09-13",108.31,113.31,1361,401,6,1768,0.769796380090498,0.226809954751131
"1350","2013-09-20",104.7,110.22,1369,386,6,1761,0.777399204997161,0.219193639977286
"1351","2013-09-27",102.86,109.45,1362,376,6,1744,0.780963302752294,0.215596330275229
"1352","2013-10-04",103.83,109.42,1372,378,6,1756,0.781321184510251,0.215261958997722
"1353","2013-10-11",102.17,110.65,1367,369,7,1743,0.784279977051061,0.211703958691911
"1354","2013-10-18",100.87,109.4,1361,372,6,1739,0.782633697527315,0.213916043703278
"1355","2013-10-25",97.4,105.7,1357,376,5,1738,0.78078250863061,0.216340621403913
"1356","2013-11-01",94.56,105.78,1376,360,6,1742,0.789896670493685,0.206659012629162
"1357","2013-11-08",94.56,104.29,1383,365,6,1754,0.7884834663626,0.208095781071836
"1358","2013-11-15",93.8,108.25,1385,370,7,1762,0.786038592508513,0.209988649262202
"1359","2013-11-22",94.53,111.36,1387,369,5,1761,0.787620670073822,0.20954003407155
"1360","2013-11-27",92.05,111.32,1391,367,5,1763,0.788996029495179,0.208167895632445
"1361","2013-12-06",97.48,111.5,1397,375,3,1775,0.787042253521127,0.211267605633803
"1362","2013-12-13",96.27,108.08,1411,369,2,1782,0.791806958473625,0.207070707070707
"1363","2013-12-20",99.11,112.15,1395,372,1,1768,0.789027149321267,0.210407239819005
"1364","2013-12-27",99.94,112.06,1382,374,1,1757,0.786568013659647,0.212862834376779
"1365","2014-01-03",93.66,106.57,1378,372,1,1751,0.78697886921759,0.212450028555111
"1366","2014-01-10",92.39,106.44,1393,357,4,1754,0.794184720638541,0.203534777651083
"1367","2014-01-17",93.96,108.45,1408,365,4,1777,0.792346651660101,0.205402363534046
"1368","2014-01-24",96.66,109.14,1416,356,5,1777,0.796848621271806,0.200337647720878
"1369","2014-01-31",97.55,108.16,1422,358,5,1785,0.796638655462185,0.200560224089636
"1370","2014-02-07",99.98,110.12,1416,351,4,1771,0.799548277809147,0.19819311123659
"1371","2014-02-14",100.31,108.63,1423,337,4,1764,0.806689342403628,0.191043083900227
"1372","2014-02-21",102.53,109.03,1425,342,4,1771,0.804630152456239,0.193111236589497
"1373","2014-02-28",102.88,108.98,1430,335,4,1769,0.808366308648954,0.189372526851328
"1374","2014-03-07",102.82,109.14,1443,345,4,1792,0.805245535714286,0.192522321428571
"1375","2014-03-14",99.23,108.08,1461,344,4,1809,0.807628524046435,0.190160309563295
"1376","2014-03-21",99.97,107.2,1473,326,4,1803,0.816971713810316,0.180809761508597
"1377","2014-03-28",101.73,106.64,1487,318,4,1809,0.822001105583195,0.175787728026534
"1378","2014-04-04",101.16,106.41,1498,316,4,1818,0.823982398239824,0.173817381738174
"1379","2014-04-11",103.68,107.34,1517,310,4,1831,0.828509011469143,0.169306389950847
"1380","2014-04-17",104.33,109.79,1510,316,5,1831,0.824685963954123,0.172583287820863
"1381","2014-04-25",100.85,109.53,1534,323,4,1861,0.824288017195056,0.173562600752284
"1382","2014-05-02",100.09,109.48,1527,323,4,1854,0.823624595469256,0.174217907227616
"1383","2014-05-09",100.32,108.26,1528,323,4,1855,0.823719676549865,0.174123989218329
"1384","2014-05-16",102.31,110.9,1531,326,4,1861,0.822675980655562,0.175174637291779
"1385","2014-05-23",105.01,110.19,1528,325,4,1857,0.822832525578891,0.175013462574044
"1386","2014-05-30",103.4,109.21,1536,326,4,1866,0.823151125401929,0.17470525187567
"1387","2014-06-06",103.32,109.21,1536,320,4,1860,0.825806451612903,0.172043010752688
"1388","2014-06-13",107.49,113.15,1542,310,2,1854,0.831715210355987,0.167206040992449
"1389","2014-06-20",107.95,114.55,1545,311,2,1858,0.831539289558665,0.167384284176534
"1390","2014-06-27",106.46,112.62,1558,314,1,1873,0.831820608649226,0.167645488521089
"1391","2014-07-03",104.76,108.98,1562,311,1,1874,0.833511205976521,0.165955176093917
"1392","2014-07-11",101.48,105.77,1563,311,1,1875,0.8336,0.165866666666667
"1393","2014-07-18",103.83,106.03,1554,315,2,1871,0.830571886691609,0.168359166221272
"1394","2014-07-25",105.23,106.89,1562,318,3,1883,0.829527349973447,0.168879447689857
"1395","2014-08-01",97.86,103.45,1573,313,3,1889,0.832715722604553,0.16569613552144
"1396","2014-08-08",97.61,103.36,1588,316,4,1908,0.832285115303983,0.165618448637317
"1397","2014-08-15",97.3,101.13,1589,321,3,1913,0.830632514375327,0.167799268165186
"1398","2014-08-22",93.61,100.09,1564,330,2,1896,0.824894514767933,0.174050632911392
"1399","2014-08-29",97.86,101.12,1575,338,1,1914,0.822884012539185,0.176593521421108
"1400","2014-09-05",93.32,99.51,1584,340,1,1925,0.822857142857143,0.176623376623377
"1401","2014-09-12",92.18,96.31,1592,338,1,1931,0.824443293630243,0.175038839979285
"1402","2014-09-19",92.43,96.75,1601,329,1,1931,0.829104091144485,0.170378042465044
"1403","2014-09-26",95.55,95.08,1592,338,1,1931,0.824443293630243,0.175038839979285
"1404","2014-10-03",89.76,90.8,1591,330,1,1922,0.827783558792924,0.171696149843913
"1405","2014-10-10",85.87,88.66,1609,320,1,1930,0.833678756476684,0.16580310880829
"1406","2014-10-17",82.8,85.27,1590,328,0,1918,0.828988529718457,0.171011470281543
"1407","2014-10-24",81.27,86,1595,332,0,1927,0.827711468604048,0.172288531395952
"1408","2014-10-31",80.53,84.17,1582,346,1,1929,0.820114048729912,0.179367547952307
"1409","2014-11-07",78.71,83.2,1568,356,1,1925,0.814545454545455,0.184935064935065
"1410","2014-11-14",75.91,77.51,1578,350,0,1928,0.818464730290456,0.181535269709544
"1411","2014-11-21",76.52,79.2,1574,355,0,1929,0.815966822187662,0.184033177812338
"1412","2014-11-26",73.7,77.39,1572,344,1,1917,0.820031298904538,0.179447052686489
"1413","2014-12-05",65.89,68,1575,344,1,1920,0.8203125,0.179166666666667
"1414","2014-12-12",57.81,61.67,1546,346,1,1893,0.816693079767565,0.182778658214474
"1415","2014-12-19",56.91,58.87,1536,338,1,1875,0.8192,0.180266666666667
"1416","2014-12-26",54.59,58.72,1499,340,1,1840,0.814673913043478,0.184782608695652
"1417","2015-01-02",52.72,55.38,1482,328,1,1811,0.818332413031474,0.18111540585312
"1418","2015-01-09",48.35,47.64,1421,329,0,1750,0.812,0.188
"1419","2015-01-16",48.49,47.38,1366,310,0,1676,0.815035799522673,0.184964200477327
"1420","2015-01-23",45.26,46.69,1317,316,0,1633,0.806491120636865,0.193508879363135
"1421","2015-01-30",47.79,47.52,1223,319,1,1543,0.792611795204148,0.206740116655865
"1422","2015-02-06",51.66,55.88,1140,314,2,1456,0.782967032967033,0.215659340659341
"1423","2015-02-13",52.66,60.33,1056,300,2,1358,0.777614138438881,0.220913107511046
"1424","2015-02-20",49.95,60.99,1019,289,2,1310,0.777862595419847,0.220610687022901
"1425","2015-02-27",49.84,61.89,986,280,1,1267,0.778216258879242,0.220994475138122
"1426","2015-03-06",49.61,59.15,922,268,2,1192,0.773489932885906,0.224832214765101
"1427","2015-03-13",44.88,54.8,866,257,2,1125,0.769777777777778,0.228444444444444
"1428","2015-03-20",46,53.88,825,242,2,1069,0.771749298409729,0.226379794200187
"1429","2015-03-27",48.83,56.44,813,233,2,1048,0.775763358778626,0.222328244274809
"1430","2015-04-02",49.13,55.73,802,222,4,1028,0.780155642023346,0.215953307392996
"1431","2015-04-10",51.63,56.82,760,225,3,988,0.769230769230769,0.227732793522267
"1432","2015-04-17",55.71,61.31,734,217,3,954,0.769392033542977,0.227463312368973
"1433","2015-04-24",55.98,62.96,703,225,4,932,0.754291845493562,0.241416309012876
"1434","2015-05-01",59.1,64.13,679,222,4,905,0.750276243093923,0.245303867403315
"1435","2015-05-08",59.41,63.82,668,221,5,894,0.747203579418344,0.247203579418345
"1436","2015-05-15",59.73,64.69,660,223,5,888,0.743243243243243,0.251126126126126
"1437","2015-05-22",58.88,64.7,659,222,4,885,0.744632768361582,0.250847457627119
"1438","2015-05-29",60.25,63.16,646,225,4,875,0.738285714285714,0.257142857142857
"1439","2015-06-05",59.11,60.36,642,222,4,868,0.73963133640553,0.255760368663594
"1440","2015-06-12",59.96,63.19,635,221,3,859,0.739231664726426,0.257275902211874
"1441","2015-06-19",59.62,59.41,631,223,3,857,0.736289381563594,0.260210035005834
"1442","2015-06-26",59.41,60.14,628,228,3,859,0.731082654249127,0.265424912689174
"1443","2015-07-02",56.93,61.73,640,219,3,862,0.74245939675174,0.254060324825986
"1444","2015-07-10",52.74,57.72,645,217,1,863,0.74739281575898,0.251448435689455
"1445","2015-07-17",50.88,56.38,638,218,1,857,0.744457409568261,0.254375729288215
"1446","2015-07-24",47.98,54.29,659,216,1,876,0.752283105022831,0.246575342465753
"1447","2015-07-31",47.11,53.29,664,209,1,874,0.759725400457666,0.239130434782609
"1448","2015-08-07",43.87,47.54,670,213,1,884,0.757918552036199,0.240950226244344
"1449","2015-08-14",42.45,47.79,672,211,1,884,0.760180995475113,0.23868778280543
"1450","2015-08-21",40.45,43.84,674,211,0,885,0.761581920903955,0.238418079096045
"1451","2015-08-28",45.29,47.97,675,202,0,877,0.769669327251995,0.230330672748005
"1452","2015-09-04",46.02,48.59,662,202,0,864,0.766203703703704,0.233796296296296
"1453","2015-09-11",44.75,46.87,652,196,0,848,0.768867924528302,0.231132075471698
"1454","2015-09-18",44.71,47.28,644,198,0,842,0.764845605700713,0.235154394299287
"1455","2015-09-25",45.55,47.28,641,197,0,838,0.76491646778043,0.23508353221957
"1456","2015-10-02",45.54,46.55,614,195,0,809,0.758961681087763,0.241038318912237
"1457","2015-10-09",49.67,52.08,605,189,1,795,0.761006289308176,0.237735849056604
"1458","2015-10-16",47.3,48.96,595,192,0,787,0.756035578144854,0.243964421855146
"1459","2015-10-23",43.91,46.3,594,193,0,787,0.754764930114358,0.245235069885642
"1460","2015-10-30",46.6,48,578,197,0,775,0.745806451612903,0.254193548387097
"1461","2015-11-06",44.32,46.09,572,199,0,771,0.74189364461738,0.25810635538262
"1462","2015-11-13",40.69,41.98,574,193,0,767,0.748370273794003,0.251629726205997
"1463","2015-11-20",39.39,42.49,564,193,0,757,0.745046235138705,0.254953764861295
"1464","2015-11-25",41.22,43.56,555,189,0,744,0.745967741935484,0.254032258064516
"1465","2015-12-04",40,41.44,545,192,0,737,0.739484396200814,0.260515603799186
"1466","2015-12-11",35.65,36.99,524,185,0,709,0.739069111424542,0.260930888575458
"1467","2015-12-18",34.72,36.76,541,168,0,709,0.763046544428773,0.236953455571227
"1468","2015-12-23",36.76,35.79,538,162,0,700,0.768571428571429,0.231428571428571
"1469","2015-12-31",37.13,36.61,536,162,0,698,0.767908309455587,0.232091690544413
"1470","2016-01-08",33.2,31.67,516,148,0,664,0.77710843373494,0.22289156626506
"1471","2016-01-15",29.45,28.8,515,135,0,650,0.792307692307692,0.207692307692308
"1472","2016-01-22",32.07,30.46,510,127,0,637,0.800627943485086,0.199372056514914
"1473","2016-01-29",33.66,33.14,498,121,0,619,0.804523424878837,0.195476575121163
"1474","2016-02-05",30.86,32.35,467,104,0,571,0.817863397548161,0.182136602451839
"1475","2016-02-12",29.32,31.8,439,102,0,541,0.811460258780037,0.188539741219963
"1476","2016-02-19",29.59,31.66,413,101,0,514,0.803501945525292,0.196498054474708
"1477","2016-02-26",31.65,35.76,400,102,0,502,0.796812749003984,0.203187250996016
"1478","2016-03-04",35.91,37.61,392,97,0,489,0.801635991820041,0.198364008179959
"1479","2016-03-11",38.51,39.41,386,94,0,480,0.804166666666667,0.195833333333333
"1480","2016-03-18",39.47,39.26,387,89,0,476,0.813025210084034,0.186974789915966
"1481","2016-03-24",38.14,38.33,372,92,0,464,0.801724137931034,0.198275862068966
"1482","2016-04-01",35.36,36.42,362,88,0,450,0.804444444444444,0.195555555555556
"1483","2016-04-08",39.74,40.71,354,89,0,443,0.799097065462754,0.200902934537246
"1484","2016-04-15",40.4,41.32,351,89,0,440,0.797727272727273,0.202272727272727
"1485","2016-04-22",42.76,43.97,343,88,0,431,0.795823665893271,0.204176334106729
"1486","2016-04-29",45.98,45.64,332,87,1,420,0.790476190476191,0.207142857142857
"1487","2016-05-06",44.58,44.6,328,86,1,415,0.790361445783132,0.207228915662651
"1488","2016-05-13",46.22,47.05,318,87,1,406,0.783251231527094,0.214285714285714
"1489","2016-05-20",47.67,48.54,318,85,1,404,0.787128712871287,0.21039603960396
"1490","2016-05-27",49.36,49.09,316,87,1,404,0.782178217821782,0.215346534653465
"1491","2016-06-03",48.69,48.5,325,82,1,408,0.79656862745098,0.200980392156863
"1492","2016-06-10",49.09,49.7,328,85,1,414,0.792270531400966,0.205314009661836
"1493","2016-06-17",48,46.57,337,86,1,424,0.794811320754717,0.202830188679245
"1494","2016-06-24",46.7,46.69,330,90,1,421,0.783847980997625,0.213776722090261
"1495","2016-07-01",49.02,47.65,341,89,1,431,0.791183294663573,0.206496519721578
"1496","2016-07-08",45.37,44.53,351,88,1,440,0.797727272727273,0.2
"1497","2016-07-15",45.93,46.25,357,89,1,447,0.798657718120805,0.19910514541387
"1498","2016-07-22",43.41,44.24,371,88,3,462,0.803030303030303,0.19047619047619
"1499","2016-07-29",41.54,40.76,374,86,3,463,0.807775377969763,0.185745140388769
"1500","2016-08-05",41.83,42.47,381,81,2,464,0.821120689655172,0.174568965517241
"1501","2016-08-12",44.47,45.12,396,83,2,481,0.823284823284823,0.172557172557173
"1502","2016-08-19",48.48,49.39,406,83,2,491,0.826883910386965,0.169042769857434
"1503","2016-08-26",47.64,49.66,406,81,2,489,0.830265848670757,0.165644171779141
"1504","2016-09-02",44.39,45.96,407,88,2,497,0.818913480885312,0.177062374245473
"1505","2016-09-09",45.88,48.37,414,92,2,508,0.81496062992126,0.181102362204724
"1506","2016-09-16",43.04,45.26,416,89,1,506,0.822134387351779,0.175889328063241
"1507","2016-09-23",44.36,46.71,418,92,1,511,0.818003913894325,0.180039138943249
"1508","2016-09-30",47.72,48.24,425,96,1,522,0.814176245210728,0.183908045977012
"1509","2016-10-07",49.76,50.49,428,94,2,524,0.816793893129771,0.179389312977099
"1510","2016-10-14",50.35,48.87,432,105,2,539,0.801484230055659,0.194805194805195
"1511","2016-10-21",50.61,50.28,443,108,2,553,0.801084990958409,0.195298372513562
"1512","2016-10-28",48.72,47.78,441,114,2,557,0.791741472172352,0.204667863554758
"1513","2016-11-04",44.07,43.06,450,117,2,569,0.790861159929701,0.205623901581722
"1514","2016-11-11",43.39,41.61,452,115,1,568,0.795774647887324,0.202464788732394
"1515","2016-11-18",45.69,44.41,471,116,1,588,0.801020408163265,0.197278911564626
"1516","2016-11-23",46.72,46.54,474,118,1,593,0.799325463743676,0.198988195615514
"1517","2016-12-02",51.7,52.35,477,119,1,597,0.798994974874372,0.199329983249581
"1518","2016-12-09",51.51,52.19,498,125,1,624,0.798076923076923,0.200320512820513
"1519","2016-12-16",51.93,54.15,510,126,1,637,0.800627943485086,0.197802197802198
"1520","2016-12-23",52.01,53.93,523,129,1,653,0.800918836140888,0.197549770290965
"1521","2016-12-30",53.75,54.96,525,132,1,658,0.797872340425532,0.200607902735562
"1522","2017-01-06",53.98,55.9,529,135,1,665,0.795488721804511,0.203007518796992
"1523","2017-01-13",52.36,54.37,522,136,1,659,0.792109256449165,0.206373292867982
"1524","2017-01-20",52.33,55.04,551,142,1,694,0.793948126801153,0.204610951008646
"1525","2017-01-27",53.18,54.8,566,145,1,712,0.794943820224719,0.203651685393258
"1526","2017-02-03",53.81,55.92,583,145,1,729,0.799725651577503,0.198902606310014
"1527","2017-02-10",53.84,55.2,591,149,1,741,0.797570850202429,0.201079622132254
"1528","2017-02-17",53.41,54.48,597,153,1,751,0.794940079893475,0.203728362183755
"1529","2017-02-24",53.99,54.69,602,151,1,754,0.79840848806366,0.20026525198939
"1530","2017-03-03",53.33,54.12,609,146,1,756,0.805555555555556,0.193121693121693
"1531","2017-03-10",48.05,50.63,617,151,0,768,0.803385416666667,0.196614583333333
"1532","2017-03-17",48.34,50.58,631,157,1,789,0.799746514575412,0.198986058301648
"1533","2017-03-24",47.3,49.97,652,155,2,809,0.80593325092707,0.19159456118665
"1534","2017-03-31",50.54,52.2,662,160,2,824,0.803398058252427,0.194174757281553
"1535","2017-04-07",52.25,54.24,672,165,2,839,0.800953516090584,0.196662693682956
"1536","2017-04-13",53.19,55.05,683,162,2,847,0.806375442739079,0.191263282172373
"1537","2017-04-21",49.64,49.93,688,167,2,857,0.802800466744457,0.194865810968495
"1538","2017-04-28",49.31,49.46,697,171,2,870,0.801149425287356,0.196551724137931
"1539","2017-05-05",46.23,47.45,703,173,1,877,0.801596351197263,0.197263397947548
"1540","2017-05-12",47.83,49.08,712,172,1,885,0.804519774011299,0.194350282485876
"1541","2017-05-19",50.32,52.78,720,180,1,901,0.799112097669256,0.199778024417314
"1542","2017-05-26",49.58,50.84,722,185,1,908,0.795154185022026,0.203744493392071
"1543","2017-06-02",47.68,48.46,733,182,1,916,0.800218340611354,0.198689956331878
"1544","2017-06-09",45.82,46.64,741,185,1,927,0.799352750809062,0.199568500539374
"1545","2017-06-16",44.73,45.7,747,186,0,933,0.80064308681672,0.19935691318328
"1546","2017-06-23",42.86,44.14,758,183,0,941,0.805526036131775,0.194473963868225
"1547","2017-06-30",46.02,47.08,756,184,0,940,0.804255319148936,0.195744680851064
"1548","2017-07-07",44.25,46.47,763,189,0,952,0.801470588235294,0.198529411764706
"1549","2017-07-14",46.53,47.89,765,187,0,952,0.803571428571429,0.196428571428571
"1550","2017-07-21",45.78,47.47,764,186,0,950,0.804210526315789,0.195789473684211
"1551","2017-07-28",49.72,52,766,192,0,958,0.799582463465553,0.200417536534447
"1552","2017-08-04",49.57,52.48,765,189,0,954,0.80188679245283,0.19811320754717
"1553","2017-08-11",48.81,51.47,768,181,0,949,0.80927291886196,0.19072708113804
"1554","2017-08-18",48.59,50.96,763,182,1,946,0.806553911205074,0.192389006342495
"1555","2017-08-25",47.65,51.87,759,180,1,940,0.807446808510638,0.191489361702128
"1556","2017-09-01",47.32,53.15,759,183,1,943,0.804878048780488,0.19406150583245
"1557","2017-09-08",47.44,54.55,756,187,1,944,0.800847457627119,0.198093220338983
"1558","2017-09-15",49.9,56.18,749,186,1,936,0.800213675213675,0.198717948717949
"1559","2017-09-22",50.33,58.16,744,190,1,935,0.79572192513369,0.203208556149733
"1560","2017-09-29",51.67,57.02,750,189,1,940,0.797872340425532,0.201063829787234
"1561","2017-10-06",49.34,55.5,748,187,1,936,0.799145299145299,0.199786324786325
"1562","2017-10-13",51.43,56.86,743,185,0,928,0.800646551724138,0.199353448275862
"1563","2017-10-20",51.63,57.89,736,177,0,913,0.806133625410734,0.193866374589266
