"","Date","Oil","Gas","Misc","Total","X..Oil","X..Gas"
"1",1987-07-17,559,337,26,922,0.606290672451193,0.365509761388286
"2",1987-07-24,565,331,21,917,0.616139585605234,0.360959651035987
"3",1987-07-31,605,346,22,973,0.621788283658787,0.355601233299075
"4",1987-08-07,613,349,21,983,0.623601220752798,0.355035605289929
"5",1987-08-14,620,352,26,998,0.62124248496994,0.352705410821643
"6",1987-08-21,627,354,31,1012,0.619565217391304,0.349802371541502
"7",1987-08-28,665,361,23,1049,0.63393708293613,0.344137273593899
"8",1987-09-04,704,369,26,1099,0.640582347588717,0.335759781619654
"9",1987-09-11,718,364,26,1108,0.648014440433213,0.328519855595668
"10",1987-09-18,711,367,23,1101,0.645776566757493,0.333333333333333
"11",1987-09-25,718,356,20,1094,0.656307129798903,0.325411334552102
"12",1987-10-02,721,367,39,1127,0.639751552795031,0.32564330079858
"13",1987-10-09,723,378,3,1104,0.654891304347826,0.342391304347826
"14",1987-10-16,725,391,18,1134,0.639329805996473,0.344797178130512
"15",1987-10-23,740,372,18,1130,0.654867256637168,0.329203539823009
"16",1987-10-30,738,374,19,1131,0.652519893899204,0.330680813439434
"17",1987-11-06,734,387,20,1141,0.643295354951797,0.339176161262051
"18",1987-11-13,760,393,21,1174,0.647359454855196,0.334752981260647
"19",1987-11-20,746,386,20,1152,0.647569444444444,0.335069444444444
"20",1987-11-27,750,389,22,1161,0.645994832041344,0.335055986218777
"21",1987-12-04,757,394,1,1152,0.657118055555556,0.342013888888889
"22",1987-12-11,764,399,18,1181,0.646909398814564,0.337849280270957
"23",1987-12-18,745,405,18,1168,0.637842465753425,0.346746575342466
"24",1987-12-25,716,412,17,1145,0.625327510917031,0.359825327510917
"25",1988-01-01,710,392,19,1121,0.633363068688671,0.349687778768956
"26",1988-01-08,689,390,23,1102,0.625226860254084,0.353901996370236
"27",1988-01-15,641,392,21,1054,0.608159392789374,0.371916508538899
"28",1988-01-22,611,390,25,1026,0.59551656920078,0.380116959064327
"29",1988-01-29,573,366,25,964,0.594398340248963,0.379668049792531
"30",1988-02-05,580,381,25,986,0.588235294117647,0.386409736308316
"31",1988-02-12,557,385,26,968,0.575413223140496,0.397727272727273
"32",1988-02-19,575,377,26,978,0.587934560327198,0.385480572597137
"33",1988-02-26,592,365,26,983,0.602238046795524,0.371312309257375
"34",1988-03-04,591,360,27,978,0.604294478527607,0.368098159509202
"35",1988-03-11,572,342,32,946,0.604651162790698,0.361522198731501
"36",1988-03-18,583,326,34,943,0.618239660657476,0.345705196182397
"37",1988-03-25,580,322,33,935,0.620320855614973,0.344385026737968
"38",1988-04-01,577,330,34,941,0.613177470775771,0.350690754516472
"39",1988-04-08,566,315,35,916,0.617903930131004,0.343886462882096
"40",1988-04-15,560,310,34,904,0.619469026548673,0.342920353982301
"41",1988-04-22,566,307,35,908,0.623348017621145,0.338105726872247
"42",1988-04-29,541,308,31,880,0.614772727272727,0.35
"43",1988-05-06,563,308,26,897,0.627647714604236,0.343366778149387
"44",1988-05-13,557,299,27,883,0.630804077010193,0.338618346545866
"45",1988-05-20,571,291,30,892,0.640134529147982,0.326233183856502
"46",1988-05-27,576,295,34,905,0.63646408839779,0.325966850828729
"47",1988-06-03,562,304,32,898,0.625835189309577,0.338530066815145
"48",1988-06-10,544,310,35,889,0.611923509561305,0.348706411698538
"49",1988-06-17,550,321,34,905,0.607734806629834,0.354696132596685
"50",1988-06-24,558,301,35,894,0.624161073825503,0.33668903803132
"51",1988-07-01,572,314,35,921,0.621064060803475,0.340933767643865
"52",1988-07-08,573,318,35,926,0.618790496760259,0.34341252699784
"53",1988-07-15,565,297,37,899,0.628476084538376,0.330367074527253
"54",1988-07-22,560,308,35,903,0.62015503875969,0.341085271317829
"55",1988-07-29,549,314,31,894,0.614093959731544,0.351230425055928
"56",1988-08-05,575,340,30,945,0.608465608465609,0.35978835978836
"57",1988-08-12,572,335,33,940,0.608510638297872,0.356382978723404
"58",1988-08-19,566,342,29,937,0.604055496264675,0.364994663820704
"59",1988-08-26,561,346,28,935,0.6,0.370053475935829
"60",1988-09-02,526,381,26,933,0.563772775991426,0.408360128617363
"61",1988-09-09,513,399,26,938,0.546908315565032,0.425373134328358
"62",1988-09-16,499,396,26,921,0.541802388707926,0.429967426710098
"63",1988-09-23,510,383,24,917,0.556161395856052,0.417666303162486
"64",1988-09-30,523,370,25,918,0.569716775599129,0.403050108932462
"65",1988-10-07,514,372,28,914,0.562363238512035,0.407002188183807
"66",1988-10-14,524,373,28,925,0.566486486486487,0.403243243243243
"67",1988-10-21,526,379,28,933,0.563772775991426,0.406216505894963
"68",1988-10-28,504,391,28,923,0.546045503791983,0.423618634886241
"69",1988-11-04,505,416,21,942,0.536093418259023,0.441613588110403
"70",1988-11-11,471,403,23,897,0.525083612040134,0.449275362318841
"71",1988-11-18,491,409,23,923,0.531960996749729,0.443120260021669
"72",1988-11-25,494,395,22,911,0.542261251372119,0.433589462129528
"73",1988-12-02,487,397,21,905,0.538121546961326,0.438674033149171
"74",1988-12-09,512,390,20,922,0.55531453362256,0.422993492407809
"75",1988-12-16,510,400,20,930,0.548387096774194,0.43010752688172
"76",1988-12-23,519,400,21,940,0.552127659574468,0.425531914893617
"77",1988-12-30,505,384,19,908,0.556167400881057,0.422907488986784
"78",1989-01-06,475,375,22,872,0.544724770642202,0.430045871559633
"79",1989-01-13,470,346,24,840,0.55952380952381,0.411904761904762
"80",1989-01-20,412,354,23,789,0.522179974651458,0.448669201520913
"81",1989-01-27,414,362,21,797,0.519447929736512,0.454203262233375
"82",1989-02-03,396,363,21,780,0.507692307692308,0.465384615384615
"83",1989-02-10,389,334,23,746,0.521447721179625,0.447721179624665
"84",1989-02-17,392,350,24,766,0.511749347258486,0.456919060052219
"85",1989-02-24,391,341,25,757,0.516512549537649,0.450462351387054
"86",1989-03-03,400,337,24,761,0.525624178712221,0.442838370565046
"87",1989-03-10,398,327,18,743,0.535666218034993,0.440107671601615
"88",1989-03-17,405,314,21,740,0.547297297297297,0.424324324324324
"89",1989-03-24,424,320,22,766,0.553524804177546,0.417754569190601
"90",1989-03-31,417,341,21,779,0.535301668806162,0.437740693196406
"91",1989-04-07,429,325,24,778,0.551413881748072,0.417737789203085
"92",1989-04-14,433,304,21,758,0.571240105540897,0.401055408970976
"93",1989-04-21,430,317,20,767,0.560625814863103,0.413298565840939
"94",1989-04-28,426,305,20,751,0.567243675099867,0.40612516644474
"95",1989-05-05,436,311,17,764,0.570680628272251,0.407068062827225
"96",1989-05-12,451,310,10,771,0.584954604409857,0.402075226977951
"97",1989-05-19,425,304,8,737,0.576662143826323,0.412483039348711
"98",1989-05-26,419,323,7,749,0.559412550066756,0.431241655540721
"99",1989-06-02,429,341,14,784,0.54719387755102,0.434948979591837
"100",1989-06-09,427,353,11,791,0.539823008849558,0.446270543615676
"101",1989-06-16,409,367,19,795,0.514465408805031,0.461635220125786
"102",1989-06-23,428,368,14,810,0.528395061728395,0.454320987654321
"103",1989-06-30,439,364,14,817,0.537331701346389,0.445532435740514
"104",1989-07-07,436,373,16,825,0.528484848484848,0.452121212121212
"105",1989-07-14,424,382,14,820,0.517073170731707,0.465853658536585
"106",1989-07-21,417,399,14,830,0.502409638554217,0.480722891566265
"107",1989-07-28,445,413,12,870,0.511494252873563,0.474712643678161
"108",1989-08-04,445,420,9,874,0.509153318077803,0.480549199084668
"109",1989-08-11,433,414,11,858,0.504662004662005,0.482517482517483
"110",1989-08-18,426,463,14,903,0.471760797342193,0.512735326688815
"111",1989-08-25,442,456,11,909,0.486248624862486,0.501650165016502
"112",1989-09-01,451,474,11,936,0.481837606837607,0.506410256410256
"113",1989-09-08,449,490,11,950,0.472631578947368,0.515789473684211
"114",1989-09-15,468,486,11,965,0.484974093264249,0.503626943005181
"115",1989-09-22,472,485,10,967,0.488107549120993,0.501551189245088
"116",1989-09-29,480,489,9,978,0.49079754601227,0.5
"117",1989-10-06,468,485,7,960,0.4875,0.505208333333333
"118",1989-10-13,498,475,8,981,0.507645259938838,0.484199796126402
"119",1989-10-20,502,480,10,992,0.506048387096774,0.483870967741936
"120",1989-10-27,516,482,12,1010,0.510891089108911,0.477227722772277
"121",1989-11-03,539,491,12,1042,0.517274472168906,0.471209213051823
"122",1989-11-10,545,487,13,1045,0.521531100478469,0.466028708133971
"123",1989-11-17,529,499,12,1040,0.508653846153846,0.479807692307692
"124",1989-11-24,516,514,7,1037,0.497589199614272,0.49566055930569
"125",1989-12-01,534,522,6,1062,0.502824858757062,0.491525423728814
"126",1989-12-08,528,523,7,1058,0.499054820415879,0.494328922495274
"127",1989-12-15,552,519,8,1079,0.511584800741427,0.481000926784059
"128",1989-12-22,548,505,8,1061,0.516493873704053,0.475966069745523
"129",1989-12-29,533,502,7,1042,0.511516314779271,0.481765834932822
"130",1990-01-05,532,488,9,1029,0.517006802721089,0.47424684159378
"131",1990-01-12,527,484,8,1019,0.517173699705594,0.474975466143278
"132",1990-01-19,494,462,8,964,0.512448132780083,0.479253112033195
"133",1990-01-26,482,447,8,937,0.514407684098186,0.477054429028815
"134",1990-02-02,489,434,8,931,0.525241675617616,0.466165413533835
"135",1990-02-09,495,397,7,899,0.550611790878754,0.441601779755284
"136",1990-02-16,498,413,7,918,0.542483660130719,0.449891067538126
"137",1990-02-23,485,405,7,897,0.540691192865106,0.451505016722408
"138",1990-03-02,478,409,7,894,0.534675615212528,0.457494407158837
"139",1990-03-09,482,435,6,923,0.522210184182015,0.471289274106176
"140",1990-03-16,479,424,5,908,0.527533039647577,0.466960352422908
"141",1990-03-23,474,414,5,893,0.530795072788354,0.463605823068309
"142",1990-03-30,516,425,5,946,0.545454545454545,0.449260042283298
"143",1990-04-06,487,445,5,937,0.51974386339381,0.474919957310566
"144",1990-04-13,483,447,4,934,0.517130620985011,0.478586723768737
"145",1990-04-20,462,467,3,932,0.495708154506438,0.501072961373391
"146",1990-04-27,472,451,4,927,0.509169363538296,0.486515641855448
"147",1990-05-04,475,450,5,930,0.510752688172043,0.483870967741936
"148",1990-05-11,479,458,4,941,0.509032943676939,0.486716259298619
"149",1990-05-18,504,465,3,972,0.518518518518519,0.478395061728395
"150",1990-05-25,514,485,2,1001,0.513486513486514,0.484515484515485
"151",1990-06-01,507,475,1,983,0.515768056968464,0.483214649033571
"152",1990-06-08,496,489,6,991,0.50050454086781,0.493440968718466
"153",1990-06-15,491,500,8,999,0.491491491491492,0.500500500500501
"154",1990-06-22,496,516,9,1021,0.485798237022527,0.505386875612145
"155",1990-06-29,491,516,13,1020,0.481372549019608,0.505882352941176
"156",1990-07-06,487,509,15,1011,0.481701285855589,0.503461918892186
"157",1990-07-13,491,495,15,1001,0.490509490509491,0.494505494505495
"158",1990-07-20,509,496,17,1022,0.498043052837573,0.4853228962818
"159",1990-07-27,508,466,22,996,0.51004016064257,0.467871485943775
"160",1990-08-03,494,457,15,966,0.511387163561077,0.473084886128364
"161",1990-08-10,507,472,13,992,0.511088709677419,0.475806451612903
"162",1990-08-17,511,459,17,987,0.517730496453901,0.465045592705167
"163",1990-08-24,510,475,17,1002,0.508982035928144,0.474051896207585
"164",1990-08-31,544,453,15,1012,0.537549407114625,0.447628458498024
"165",1990-09-07,570,454,15,1039,0.548604427333975,0.436958614051973
"166",1990-09-14,579,466,15,1060,0.54622641509434,0.439622641509434
"167",1990-09-21,572,467,16,1055,0.54218009478673,0.442654028436019
"168",1990-09-28,560,470,17,1047,0.534861509073544,0.448901623686724
"169",1990-10-05,590,456,18,1064,0.554511278195489,0.428571428571429
"170",1990-10-12,588,453,15,1056,0.556818181818182,0.428977272727273
"171",1990-10-19,597,480,12,1089,0.548209366391185,0.440771349862259
"172",1990-10-26,607,488,12,1107,0.5483288166215,0.440831074977416
"173",1990-11-02,620,513,11,1144,0.541958041958042,0.448426573426573
"174",1990-11-09,614,480,30,1124,0.54626334519573,0.427046263345196
"175",1990-11-16,606,474,23,1103,0.549410698096102,0.42973708068903
"176",1990-11-23,620,513,42,1175,0.527659574468085,0.436595744680851
"177",1990-11-30,639,495,41,1175,0.543829787234043,0.421276595744681
"178",1990-12-07,646,495,38,1179,0.547921967769296,0.419847328244275
"179",1990-12-14,657,457,37,1151,0.570807993049522,0.397046046915726
"180",1990-12-21,634,427,28,1089,0.5821854912764,0.392102846648301
"181",1990-12-28,639,424,23,1086,0.588397790055249,0.390423572744015
"182",1991-01-04,651,432,25,1108,0.587545126353791,0.389891696750903
"183",1991-01-11,612,413,23,1048,0.583969465648855,0.394083969465649
"184",1991-01-18,631,410,24,1065,0.592488262910798,0.384976525821596
"185",1991-01-25,639,396,16,1051,0.607992388201713,0.376784015223597
"186",1991-02-01,574,409,13,996,0.576305220883534,0.410642570281125
"187",1991-02-08,575,408,14,997,0.576730190571715,0.409227683049147
"188",1991-02-15,553,407,17,977,0.566018423746162,0.416581371545548
"189",1991-02-22,555,397,15,967,0.573940020682523,0.410548086866598
"190",1991-03-01,529,400,20,949,0.557428872497366,0.421496311907271
"191",1991-03-08,534,394,20,948,0.563291139240506,0.415611814345992
"192",1991-03-15,513,374,21,908,0.564977973568282,0.411894273127753
"193",1991-03-22,503,389,19,911,0.552140504939627,0.427003293084523
"194",1991-03-29,500,393,17,910,0.54945054945055,0.431868131868132
"195",1991-04-05,480,382,19,881,0.54483541430193,0.433598183881952
"196",1991-04-12,472,383,19,874,0.540045766590389,0.438215102974828
"197",1991-04-19,450,367,18,835,0.538922155688623,0.439520958083832
"198",1991-04-26,444,347,33,824,0.538834951456311,0.421116504854369
"199",1991-05-03,425,350,30,805,0.527950310559006,0.434782608695652
"200",1991-05-10,418,353,31,802,0.521197007481297,0.440149625935162
"201",1991-05-17,422,352,44,818,0.515892420537897,0.430317848410758
"202",1991-05-24,451,361,34,846,0.533096926713948,0.426713947990544
"203",1991-05-31,435,352,37,824,0.527912621359223,0.427184466019417
"204",1991-06-07,463,344,43,850,0.544705882352941,0.404705882352941
"205",1991-06-14,479,345,47,871,0.549942594718714,0.39609644087256
"206",1991-06-21,485,340,41,866,0.560046189376444,0.392609699769053
"207",1991-06-28,505,337,39,881,0.573212258796822,0.382519863791146
"208",1991-07-05,488,332,39,859,0.568102444703143,0.386495925494761
"209",1991-07-12,467,338,39,844,0.553317535545024,0.400473933649289
"210",1991-07-19,462,328,38,828,0.557971014492754,0.396135265700483
"211",1991-07-26,470,329,46,845,0.556213017751479,0.389349112426036
"212",1991-08-02,485,314,32,831,0.583634175691937,0.377858002406739
"213",1991-08-09,452,318,26,796,0.5678391959799,0.399497487437186
"214",1991-08-16,447,326,24,797,0.560853199498118,0.409033877038896
"215",1991-08-23,434,332,26,792,0.547979797979798,0.419191919191919
"216",1991-08-30,438,339,22,799,0.548185231539424,0.424280350438048
"217",1991-09-06,436,336,26,798,0.546365914786967,0.421052631578947
"218",1991-09-13,419,309,30,758,0.552770448548813,0.407651715039578
"219",1991-09-20,440,303,27,770,0.571428571428571,0.393506493506494
"220",1991-09-27,436,306,33,775,0.56258064516129,0.394838709677419
"221",1991-10-04,434,320,32,786,0.552162849872774,0.407124681933842
"222",1991-10-11,438,317,41,796,0.550251256281407,0.398241206030151
"223",1991-10-18,427,340,30,797,0.535759096612296,0.426599749058971
"224",1991-10-25,432,341,28,801,0.539325842696629,0.425717852684145
"225",1991-11-01,432,335,26,793,0.544766708701135,0.422446406052963
"226",1991-11-08,436,329,31,796,0.547738693467337,0.413316582914573
"227",1991-11-15,455,322,26,803,0.566625155666252,0.400996264009963
"228",1991-11-22,476,333,19,828,0.57487922705314,0.402173913043478
"229",1991-11-29,484,321,17,822,0.588807785888078,0.39051094890511
"230",1991-12-06,498,299,17,814,0.611793611793612,0.367321867321867
"231",1991-12-13,479,306,17,802,0.597256857855362,0.381546134663342
"232",1991-12-20,465,312,20,797,0.583437892095358,0.391468005018821
"233",1991-12-27,433,316,21,770,0.562337662337662,0.41038961038961
"234",1992-01-03,427,313,24,764,0.55890052356021,0.409685863874346
"235",1992-01-10,405,312,15,732,0.55327868852459,0.426229508196721
"236",1992-01-17,412,291,13,716,0.575418994413408,0.406424581005587
"237",1992-01-24,383,291,12,686,0.558309037900875,0.424198250728863
"238",1992-01-31,375,265,13,653,0.57427258805513,0.405819295558959
"239",1992-02-07,383,277,14,674,0.568249258160237,0.410979228486647
"240",1992-02-14,370,279,12,661,0.559757942511347,0.422087745839637
"241",1992-02-21,373,280,14,667,0.559220389805098,0.419790104947526
"242",1992-02-28,387,273,13,673,0.575037147102526,0.405646359583952
"243",1992-03-06,382,262,16,660,0.578787878787879,0.396969696969697
"244",1992-03-13,384,249,16,649,0.591679506933744,0.38366718027735
"245",1992-03-20,380,245,18,643,0.590979782270607,0.381026438569207
"246",1992-03-27,377,242,20,639,0.589984350547731,0.378716744913928
"247",1992-04-03,382,253,23,658,0.580547112462006,0.384498480243161
"248",1992-04-10,373,251,24,648,0.575617283950617,0.387345679012346
"249",1992-04-17,369,250,20,639,0.577464788732394,0.391236306729264
"250",1992-04-24,355,251,17,623,0.569823434991974,0.402889245585875
"251",1992-05-01,354,260,20,634,0.558359621451104,0.410094637223975
"252",1992-05-08,361,256,18,635,0.568503937007874,0.403149606299213
"253",1992-05-15,371,262,19,652,0.569018404907976,0.401840490797546
"254",1992-05-22,361,257,20,638,0.565830721003135,0.40282131661442
"255",1992-05-29,344,263,22,629,0.546899841017488,0.4181240063593
"256",1992-06-05,331,256,23,610,0.542622950819672,0.419672131147541
"257",1992-06-12,335,242,19,596,0.562080536912752,0.406040268456376
"258",1992-06-19,352,264,16,632,0.556962025316456,0.417721518987342
"259",1992-06-26,353,276,16,645,0.547286821705426,0.427906976744186
"260",1992-07-03,340,291,17,648,0.524691358024691,0.449074074074074
"261",1992-07-10,343,306,18,667,0.51424287856072,0.458770614692654
"262",1992-07-17,352,320,17,689,0.51088534107402,0.4644412191582
"263",1992-07-24,351,318,19,688,0.510174418604651,0.462209302325581
"264",1992-07-31,357,317,16,690,0.517391304347826,0.459420289855072
"265",1992-08-07,356,329,24,709,0.502115655853315,0.464033850493653
"266",1992-08-14,330,326,22,678,0.486725663716814,0.480825958702065
"267",1992-08-21,334,336,19,689,0.484760522496372,0.48766328011611
"268",1992-08-28,315,333,20,668,0.471556886227545,0.498502994011976
"269",1992-09-04,342,345,19,706,0.484419263456091,0.488668555240793
"270",1992-09-11,325,346,16,687,0.473071324599709,0.503639010189229
"271",1992-09-18,348,356,16,720,0.483333333333333,0.494444444444444
"272",1992-09-25,366,377,12,755,0.48476821192053,0.499337748344371
"273",1992-10-02,364,381,11,756,0.481481481481481,0.503968253968254
"274",1992-10-09,377,399,11,787,0.479034307496823,0.506988564167726
"275",1992-10-16,393,399,11,803,0.489414694894147,0.496886674968867
"276",1992-10-23,415,403,12,830,0.5,0.485542168674699
"277",1992-10-30,410,415,13,838,0.489260143198091,0.495226730310263
"278",1992-11-06,412,429,12,853,0.483001172332943,0.502930832356389
"279",1992-11-13,430,440,15,885,0.485875706214689,0.497175141242938
"280",1992-11-20,407,469,14,890,0.457303370786517,0.526966292134832
"281",1992-11-27,421,466,12,899,0.468298109010011,0.518353726362625
"282",1992-12-04,432,470,12,914,0.472647702407002,0.514223194748359
"283",1992-12-11,425,494,11,930,0.456989247311828,0.531182795698925
"284",1992-12-18,381,528,26,935,0.407486631016043,0.564705882352941
"285",1992-12-23,378,525,25,928,0.407327586206897,0.56573275862069
"286",1992-12-30,368,527,27,922,0.399132321041215,0.571583514099783
"287",1993-01-08,356,515,32,903,0.394241417497231,0.570321151716501
"288",1993-01-15,336,467,35,838,0.400954653937948,0.55727923627685
"289",1993-01-22,325,434,35,794,0.409319899244333,0.546599496221663
"290",1993-01-29,321,401,40,762,0.421259842519685,0.526246719160105
"291",1993-02-05,304,374,42,720,0.422222222222222,0.519444444444445
"292",1993-02-12,307,350,41,698,0.439828080229226,0.501432664756447
"293",1993-02-19,306,313,37,656,0.466463414634146,0.477134146341463
"294",1993-02-26,327,300,36,663,0.493212669683258,0.452488687782805
"295",1993-03-05,311,277,32,620,0.501612903225806,0.446774193548387
"296",1993-03-12,312,257,31,600,0.52,0.428333333333333
"297",1993-03-19,318,270,26,614,0.517915309446254,0.439739413680782
"298",1993-03-26,320,267,23,610,0.524590163934426,0.437704918032787
"299",1993-03-31,326,278,23,627,0.519936204146731,0.443381180223286
"300",1993-04-08,314,278,23,615,0.510569105691057,0.452032520325203
"301",1993-04-16,319,262,22,603,0.529021558872305,0.434494195688226
"302",1993-04-23,320,265,23,608,0.526315789473684,0.435855263157895
"303",1993-04-30,319,268,22,609,0.523809523809524,0.440065681444992
"304",1993-05-07,319,278,20,617,0.517017828200972,0.450567260940032
"305",1993-05-14,316,283,20,619,0.510500807754443,0.45718901453958
"306",1993-05-21,321,298,22,641,0.500780031201248,0.464898595943838
"307",1993-05-28,334,315,22,671,0.497764530551416,0.469448584202683
"308",1993-06-04,340,325,21,686,0.495626822157434,0.473760932944606
"309",1993-06-11,365,327,19,711,0.513361462728551,0.459915611814346
"310",1993-06-18,344,321,16,681,0.505139500734214,0.47136563876652
"311",1993-06-25,351,335,16,702,0.5,0.477207977207977
"312",1993-07-02,364,353,15,732,0.497267759562842,0.48224043715847
"313",1993-07-09,353,346,14,713,0.495091164095372,0.485273492286115
"314",1993-07-16,362,346,12,720,0.502777777777778,0.480555555555556
"315",1993-07-23,376,376,13,765,0.491503267973856,0.491503267973856
"316",1993-07-30,385,380,11,776,0.496134020618557,0.489690721649485
"317",1993-08-06,389,377,10,776,0.501288659793814,0.485824742268041
"318",1993-08-13,404,371,11,786,0.513994910941476,0.472010178117048
"319",1993-08-20,400,395,10,805,0.496894409937888,0.490683229813665
"320",1993-08-27,396,417,9,822,0.481751824817518,0.507299270072993
"321",1993-09-03,405,419,10,834,0.485611510791367,0.502398081534772
"322",1993-09-10,405,421,9,835,0.48502994011976,0.504191616766467
"323",1993-09-17,423,422,11,856,0.494158878504673,0.492990654205608
"324",1993-09-24,440,420,6,866,0.508083140877598,0.484988452655889
"325",1993-10-01,427,422,7,856,0.498831775700935,0.492990654205608
"326",1993-10-08,435,414,7,856,0.508177570093458,0.483644859813084
"327",1993-10-15,443,409,8,860,0.515116279069767,0.475581395348837
"328",1993-10-22,450,402,8,860,0.523255813953488,0.467441860465116
"329",1993-10-29,452,410,8,870,0.519540229885057,0.471264367816092
"330",1993-11-05,444,418,8,870,0.510344827586207,0.480459770114943
"331",1993-11-12,453,412,7,872,0.519495412844037,0.472477064220184
"332",1993-11-19,449,401,7,857,0.52392065344224,0.467911318553092
"333",1993-11-26,465,400,6,871,0.533869115958668,0.459242250287026
"334",1993-12-03,443,427,6,876,0.505707762557078,0.487442922374429
"335",1993-12-10,443,417,8,868,0.51036866359447,0.480414746543779
"336",1993-12-17,445,433,5,883,0.5039637599094,0.490373725934315
"337",1993-12-22,408,430,5,843,0.483985765124555,0.510083036773428
"338",1993-12-29,385,423,6,814,0.472972972972973,0.51965601965602
"339",1994-01-07,357,442,8,807,0.442379182156134,0.547707558859975
"340",1994-01-14,365,420,7,792,0.460858585858586,0.53030303030303
"341",1994-01-21,356,413,9,778,0.457583547557841,0.530848329048843
"342",1994-01-28,345,423,10,778,0.443444730077121,0.543701799485861
"343",1994-02-04,335,405,12,752,0.445478723404255,0.538563829787234
"344",1994-02-11,346,406,12,764,0.452879581151832,0.531413612565445
"345",1994-02-18,337,403,12,752,0.44813829787234,0.535904255319149
"346",1994-02-25,330,406,11,747,0.441767068273092,0.543507362784471
"347",1994-03-04,322,412,9,743,0.433378196500673,0.554508748317631
"348",1994-03-11,320,405,8,733,0.43656207366985,0.552523874488404
"349",1994-03-18,330,404,9,743,0.44414535666218,0.543741588156124
"350",1994-03-25,323,391,11,725,0.44551724137931,0.539310344827586
"351",1994-03-31,320,402,10,732,0.437158469945355,0.549180327868853
"352",1994-04-08,309,390,10,709,0.435825105782793,0.550070521861777
"353",1994-04-15,303,407,10,720,0.420833333333333,0.565277777777778
"354",1994-04-22,318,403,11,732,0.434426229508197,0.550546448087432
"355",1994-04-29,326,393,11,730,0.446575342465753,0.538356164383562
"356",1994-05-06,323,383,13,719,0.44923504867872,0.532684283727399
"357",1994-05-13,319,388,15,722,0.441828254847645,0.537396121883657
"358",1994-05-20,314,369,14,697,0.450502152080344,0.529411764705882
"359",1994-05-27,314,398,15,727,0.43191196698762,0.547455295735901
"360",1994-06-03,316,410,16,742,0.425876010781671,0.55256064690027
"361",1994-06-10,328,410,14,752,0.436170212765957,0.545212765957447
"362",1994-06-17,342,409,18,769,0.444733420026008,0.53185955786736
"363",1994-06-24,341,402,18,761,0.448094612352168,0.528252299605782
"364",1994-07-01,333,415,18,766,0.434725848563969,0.54177545691906
"365",1994-07-08,340,412,16,768,0.442708333333333,0.536458333333333
"366",1994-07-15,337,421,15,773,0.435963777490298,0.544631306597671
"367",1994-07-22,344,420,15,779,0.441591784338896,0.539152759948652
"368",1994-07-29,349,407,15,771,0.452658884565499,0.527885862516213
"369",1994-08-05,336,421,14,771,0.43579766536965,0.546044098573281
"370",1994-08-12,311,428,14,753,0.413014608233732,0.568393094289509
"371",1994-08-19,320,438,14,772,0.414507772020725,0.567357512953368
"372",1994-08-26,312,443,13,768,0.40625,0.576822916666667
"373",1994-09-02,308,463,13,784,0.392857142857143,0.590561224489796
"374",1994-09-09,306,463,13,782,0.391304347826087,0.592071611253197
"375",1994-09-16,326,467,11,804,0.40547263681592,0.580845771144279
"376",1994-09-23,339,484,13,836,0.405502392344498,0.578947368421053
"377",1994-09-30,348,476,14,838,0.41527446300716,0.568019093078759
"378",1994-10-07,343,472,13,828,0.414251207729469,0.570048309178744
"379",1994-10-14,348,467,13,828,0.420289855072464,0.564009661835749
"380",1994-10-21,336,471,12,819,0.41025641025641,0.575091575091575
"381",1994-10-28,341,459,13,813,0.419434194341943,0.564575645756458
"382",1994-11-04,355,456,13,824,0.430825242718447,0.553398058252427
"383",1994-11-11,365,454,14,833,0.438175270108043,0.545018007202881
"384",1994-11-18,357,468,14,839,0.425506555423123,0.557806912991657
"385",1994-11-25,367,461,14,842,0.435866983372922,0.54750593824228
"386",1994-12-02,359,454,14,827,0.43409915356711,0.548972188633616
"387",1994-12-09,361,465,15,841,0.429250891795482,0.552913198573127
"388",1994-12-16,350,442,15,807,0.433705080545229,0.547707558859975
"389",1994-12-23,351,448,14,813,0.431734317343173,0.551045510455105
"390",1994-12-30,348,428,15,791,0.439949431099874,0.541087231352718
"391",1995-01-05,328,425,13,766,0.428198433420366,0.554830287206266
"392",1995-01-13,339,407,11,757,0.44782034346103,0.537648612945839
"393",1995-01-20,319,408,9,736,0.433423913043478,0.554347826086957
"394",1995-01-27,315,405,11,731,0.430916552667579,0.554035567715458
"395",1995-02-03,319,393,12,724,0.44060773480663,0.542817679558011
"396",1995-02-10,321,375,10,706,0.454674220963173,0.531161473087819
"397",1995-02-17,336,376,12,724,0.464088397790055,0.519337016574586
"398",1995-02-24,326,355,15,696,0.468390804597701,0.510057471264368
"399",1995-03-03,333,337,14,684,0.486842105263158,0.492690058479532
"400",1995-03-10,334,330,11,675,0.494814814814815,0.488888888888889
"401",1995-03-17,326,328,13,667,0.488755622188906,0.491754122938531
"402",1995-03-24,313,327,12,652,0.480061349693252,0.501533742331288
"403",1995-03-31,302,334,12,648,0.466049382716049,0.515432098765432
"404",1995-04-07,310,347,12,669,0.463378176382661,0.518684603886398
"405",1995-04-13,325,340,11,676,0.480769230769231,0.502958579881657
"406",1995-04-21,334,337,14,685,0.487591240875912,0.491970802919708
"407",1995-04-28,343,321,16,680,0.504411764705882,0.472058823529412
"408",1995-05-05,323,321,20,664,0.48644578313253,0.483433734939759
"409",1995-05-12,329,340,20,689,0.477503628447025,0.493468795355588
"410",1995-05-19,323,332,18,673,0.479940564635958,0.49331352154532
"411",1995-05-26,325,348,17,690,0.471014492753623,0.504347826086957
"412",1995-06-02,317,343,17,677,0.468242245199409,0.506646971935007
"413",1995-06-09,303,350,21,674,0.449554896142433,0.519287833827893
"414",1995-06-16,307,340,23,670,0.458208955223881,0.507462686567164
"415",1995-06-23,301,362,21,684,0.440058479532164,0.529239766081871
"416",1995-06-30,278,364,24,666,0.417417417417417,0.546546546546547
"417",1995-07-07,299,390,25,714,0.418767507002801,0.546218487394958
"418",1995-07-14,298,398,24,720,0.413888888888889,0.552777777777778
"419",1995-07-21,305,391,23,719,0.424200278164117,0.543810848400556
"420",1995-07-28,301,417,21,739,0.407307171853857,0.564276048714479
"421",1995-08-04,318,398,16,732,0.434426229508197,0.543715846994536
"422",1995-08-11,327,394,18,739,0.442489851150203,0.533152909336942
"423",1995-08-18,330,395,19,744,0.443548387096774,0.530913978494624
"424",1995-08-25,333,410,20,763,0.436435124508519,0.53735255570118
"425",1995-09-01,330,421,21,772,0.427461139896373,0.545336787564767
"426",1995-09-08,332,415,19,766,0.433420365535248,0.54177545691906
"427",1995-09-15,335,405,19,759,0.44137022397892,0.533596837944664
"428",1995-09-22,337,418,20,775,0.434838709677419,0.539354838709677
"429",1995-09-29,333,405,17,755,0.441059602649007,0.536423841059603
"430",1995-10-06,333,405,16,754,0.441644562334218,0.537135278514589
"431",1995-10-13,335,412,16,763,0.439056356487549,0.53997378768021
"432",1995-10-20,328,422,15,765,0.428758169934641,0.551633986928105
"433",1995-10-27,331,417,13,761,0.434954007884363,0.54796320630749
"434",1995-11-03,332,418,14,764,0.43455497382199,0.547120418848168
"435",1995-11-10,332,424,13,769,0.431729518855657,0.551365409622887
"436",1995-11-17,328,440,11,779,0.421052631578947,0.564826700898588
"437",1995-11-22,327,436,11,774,0.422480620155039,0.563307493540052
"438",1995-12-01,322,440,11,773,0.416558861578267,0.569210866752911
"439",1995-12-08,333,427,12,772,0.431347150259067,0.553108808290155
"440",1995-12-15,329,424,12,765,0.430065359477124,0.554248366013072
"441",1995-12-22,328,422,12,762,0.430446194225722,0.553805774278215
"442",1995-12-29,314,420,11,745,0.421476510067114,0.563758389261745
"443",1996-01-05,297,404,10,711,0.417721518987342,0.568213783403657
"444",1996-01-12,290,406,8,704,0.411931818181818,0.576704545454545
"445",1996-01-19,300,408,8,716,0.418994413407821,0.569832402234637
"446",1996-01-26,291,404,8,703,0.413940256045519,0.574679943100996
"447",1996-02-02,295,389,9,693,0.425685425685426,0.561327561327561
"448",1996-02-09,281,407,7,695,0.40431654676259,0.585611510791367
"449",1996-02-16,285,417,5,707,0.403111739745403,0.58981612446959
"450",1996-02-23,269,431,5,705,0.381560283687943,0.611347517730496
"451",1996-03-01,265,436,6,707,0.374823196605375,0.616690240452617
"452",1996-03-08,290,421,8,719,0.403337969401947,0.585535465924896
"453",1996-03-15,284,403,6,693,0.40981240981241,0.581529581529582
"454",1996-03-22,297,422,6,725,0.409655172413793,0.582068965517241
"455",1996-03-29,296,425,7,728,0.406593406593407,0.583791208791209
"456",1996-04-05,291,426,8,725,0.401379310344828,0.587586206896552
"457",1996-04-12,283,445,7,735,0.385034013605442,0.605442176870748
"458",1996-04-19,285,451,11,747,0.381526104417671,0.603748326639893
"459",1996-04-26,284,460,13,757,0.375165125495377,0.607661822985469
"460",1996-05-03,285,449,15,749,0.380507343124166,0.599465954606142
"461",1996-05-10,290,474,8,772,0.375647668393782,0.613989637305699
"462",1996-05-17,285,463,9,757,0.376486129458388,0.611624834874505
"463",1996-05-24,291,478,6,775,0.375483870967742,0.616774193548387
"464",1996-05-31,288,472,5,765,0.376470588235294,0.616993464052288
"465",1996-06-07,301,475,5,781,0.385403329065301,0.608194622279129
"466",1996-06-14,304,464,5,773,0.393272962483829,0.60025873221216
"467",1996-06-21,295,465,5,765,0.38562091503268,0.607843137254902
"468",1996-06-28,293,480,4,777,0.377091377091377,0.617760617760618
"469",1996-07-05,292,486,4,782,0.373401534526854,0.621483375959079
"470",1996-07-12,291,493,4,788,0.369289340101523,0.625634517766498
"471",1996-07-19,296,490,4,790,0.374683544303797,0.620253164556962
"472",1996-07-26,280,482,12,774,0.361757105943152,0.622739018087855
"473",1996-08-02,297,483,21,801,0.370786516853933,0.602996254681648
"474",1996-08-09,305,483,21,809,0.377008652657602,0.597033374536465
"475",1996-08-16,298,484,23,805,0.370186335403727,0.601242236024845
"476",1996-08-23,297,499,32,828,0.358695652173913,0.602657004830918
"477",1996-08-30,288,493,31,812,0.354679802955665,0.607142857142857
"478",1996-09-06,293,492,5,790,0.370886075949367,0.622784810126582
"479",1996-09-13,300,503,5,808,0.371287128712871,0.622524752475248
"480",1996-09-20,309,511,5,825,0.374545454545455,0.619393939393939
"481",1996-09-27,302,515,5,822,0.367396593673966,0.626520681265207
"482",1996-10-04,311,503,5,819,0.37973137973138,0.614163614163614
"483",1996-10-11,312,505,10,827,0.37726723095526,0.610640870616687
"484",1996-10-18,319,514,12,845,0.377514792899408,0.608284023668639
"485",1996-10-25,336,503,14,853,0.39390386869871,0.58968347010551
"486",1996-11-01,346,491,2,839,0.412395709177592,0.585220500595948
"487",1996-11-08,349,486,3,838,0.416467780429594,0.579952267303103
"488",1996-11-15,366,481,2,849,0.431095406360424,0.566548881036514
"489",1996-11-22,374,475,2,851,0.439482961222092,0.558166862514689
"490",1996-11-27,382,477,2,861,0.443670150987224,0.554006968641115
"491",1996-12-06,366,488,2,856,0.427570093457944,0.570093457943925
"492",1996-12-13,364,475,2,841,0.43281807372176,0.564803804994055
"493",1996-12-20,360,496,2,858,0.41958041958042,0.578088578088578
"494",1996-12-27,353,496,2,851,0.414806110458284,0.582843713278496
"495",1997-01-03,363,480,2,845,0.429585798816568,0.568047337278107
"496",1997-01-10,346,477,2,825,0.419393939393939,0.578181818181818
"497",1997-01-17,335,482,1,818,0.409535452322738,0.589242053789731
"498",1997-01-24,333,481,1,815,0.408588957055215,0.590184049079755
"499",1997-01-31,333,481,1,815,0.408588957055215,0.590184049079755
"500",1997-02-07,350,481,2,833,0.420168067226891,0.577430972388956
"501",1997-02-14,362,496,2,860,0.42093023255814,0.576744186046512
"502",1997-02-21,354,508,1,863,0.410196987253766,0.58864426419467
"503",1997-02-28,357,481,2,840,0.425,0.572619047619048
"504",1997-03-07,363,517,2,882,0.41156462585034,0.586167800453515
"505",1997-03-14,366,517,2,885,0.413559322033898,0.584180790960452
"506",1997-03-21,379,525,1,905,0.41878453038674,0.580110497237569
"507",1997-03-28,400,514,1,915,0.437158469945355,0.561748633879782
"508",1997-04-04,384,533,1,918,0.418300653594771,0.580610021786492
"509",1997-04-11,371,541,1,913,0.406352683461117,0.592552026286966
"510",1997-04-18,372,511,2,885,0.420338983050847,0.577401129943503
"511",1997-04-25,365,520,4,889,0.410573678290214,0.584926884139483
"512",1997-05-02,369,508,4,881,0.418842224744608,0.576617480136209
"513",1997-05-09,374,535,4,913,0.409638554216867,0.585980284775466
"514",1997-05-16,368,545,4,917,0.401308615049073,0.59432933478735
"515",1997-05-23,387,557,4,948,0.408227848101266,0.587552742616034
"516",1997-05-30,395,562,4,961,0.411030176899063,0.58480749219563
"517",1997-06-06,404,580,4,988,0.408906882591093,0.587044534412956
"518",1997-06-13,393,585,4,982,0.40020366598778,0.595723014256619
"519",1997-06-20,393,570,3,966,0.406832298136646,0.590062111801242
"520",1997-06-27,392,572,2,966,0.405797101449275,0.592132505175984
"521",1997-07-04,380,583,2,965,0.393782383419689,0.604145077720207
"522",1997-07-11,368,593,3,964,0.381742738589212,0.615145228215768
"523",1997-07-18,381,578,3,962,0.396049896049896,0.600831600831601
"524",1997-07-25,398,583,3,984,0.404471544715447,0.592479674796748
"525",1997-08-01,410,582,3,995,0.412060301507538,0.584924623115578
"526",1997-08-08,429,555,3,987,0.434650455927052,0.562310030395137
"527",1997-08-15,417,580,2,999,0.417417417417417,0.580580580580581
"528",1997-08-22,406,596,3,1005,0.403980099502488,0.593034825870647
"529",1997-08-29,383,594,3,980,0.390816326530612,0.606122448979592
"530",1997-09-05,404,625,3,1032,0.391472868217054,0.60562015503876
"531",1997-09-12,386,623,3,1012,0.381422924901186,0.615612648221344
"532",1997-09-19,387,603,3,993,0.389728096676737,0.607250755287009
"533",1997-09-26,392,603,3,998,0.392785571142285,0.604208416833667
"534",1997-10-03,384,613,4,1001,0.383616383616384,0.612387612387612
"535",1997-10-10,392,578,4,974,0.402464065708419,0.593429158110883
"536",1997-10-17,404,579,4,987,0.409321175278622,0.586626139817629
"537",1997-10-24,397,602,4,1003,0.395812562313061,0.600199401794616
"538",1997-10-31,373,640,4,1017,0.366764995083579,0.629301868239921
"539",1997-11-07,343,638,4,985,0.348223350253807,0.647715736040609
"540",1997-11-14,359,631,4,994,0.361167002012072,0.634808853118712
"541",1997-11-21,342,601,4,947,0.361140443505808,0.634635691657867
"542",1997-11-28,371,630,4,1005,0.369154228855721,0.626865671641791
"543",1997-12-05,365,645,4,1014,0.359960552268245,0.636094674556213
"544",1997-12-12,361,647,4,1012,0.356719367588933,0.639328063241107
"545",1997-12-19,361,654,4,1019,0.354268891069676,0.64180569185476
"546",1997-12-26,357,646,4,1007,0.354518371400199,0.641509433962264
"547",1998-01-02,366,633,4,1003,0.364905284147557,0.63110667996012
"548",1998-01-09,361,625,4,990,0.364646464646465,0.631313131313131
"549",1998-01-16,387,598,4,989,0.391304347826087,0.604651162790698
"550",1998-01-23,396,595,5,996,0.397590361445783,0.597389558232932
"551",1998-01-30,389,593,5,987,0.394123606889564,0.60081053698075
"552",1998-02-06,385,584,5,974,0.395277207392197,0.59958932238193
"553",1998-02-13,385,582,5,972,0.396090534979424,0.598765432098765
"554",1998-02-20,372,612,5,989,0.376137512639029,0.618806875631952
"555",1998-02-27,376,579,5,960,0.391666666666667,0.603125
"556",1998-03-06,360,592,5,957,0.376175548589342,0.618599791013584
"557",1998-03-13,321,617,4,942,0.340764331210191,0.654989384288747
"558",1998-03-20,321,613,3,937,0.342582710779082,0.654215581643543
"559",1998-03-27,304,583,3,890,0.341573033707865,0.655056179775281
"560",1998-04-03,295,577,3,875,0.337142857142857,0.659428571428572
"561",1998-04-10,298,588,3,889,0.335208098987627,0.661417322834646
"562",1998-04-17,294,601,3,898,0.32739420935412,0.669265033407572
"563",1998-04-24,278,599,3,880,0.315909090909091,0.680681818181818
"564",1998-05-01,272,601,3,876,0.310502283105023,0.686073059360731
"565",1998-05-08,271,571,3,845,0.320710059171598,0.675739644970414
"566",1998-05-15,281,592,3,876,0.320776255707763,0.675799086757991
"567",1998-05-22,269,583,3,855,0.314619883040936,0.68187134502924
"568",1998-05-29,269,551,2,822,0.327250608272506,0.670316301703163
"569",1998-06-05,270,590,2,862,0.31322505800464,0.684454756380511
"570",1998-06-12,267,599,2,868,0.307603686635945,0.690092165898618
"571",1998-06-19,271,589,3,863,0.314020857473928,0.682502896871379
"572",1998-06-26,261,560,2,823,0.317132442284326,0.680437424058323
"573",1998-07-03,258,552,2,812,0.317733990147783,0.679802955665025
"574",1998-07-10,266,551,2,819,0.324786324786325,0.672771672771673
"575",1998-07-17,260,548,2,810,0.320987654320988,0.676543209876543
"576",1998-07-24,269,544,3,816,0.329656862745098,0.666666666666667
"577",1998-07-31,269,550,3,822,0.327250608272506,0.669099756690998
"578",1998-08-07,235,571,3,809,0.290482076637825,0.705809641532757
"579",1998-08-14,229,568,2,799,0.286608260325407,0.710888610763454
"580",1998-08-21,218,551,2,771,0.282749675745785,0.714656290531777
"581",1998-08-28,221,568,1,790,0.279746835443038,0.718987341772152
"582",1998-09-04,218,552,0,770,0.283116883116883,0.716883116883117
"583",1998-09-11,214,567,0,781,0.274007682458387,0.725992317541613
"584",1998-09-18,215,558,0,773,0.278137128072445,0.721862871927555
"585",1998-09-25,213,557,0,770,0.276623376623377,0.723376623376623
"586",1998-10-02,229,525,0,754,0.303713527851459,0.696286472148541
"587",1998-10-09,226,524,0,750,0.301333333333333,0.698666666666667
"588",1998-10-16,211,529,0,740,0.285135135135135,0.714864864864865
"589",1998-10-23,212,504,0,716,0.29608938547486,0.70391061452514
"590",1998-10-30,193,515,0,708,0.272598870056497,0.727401129943503
"591",1998-11-06,197,499,0,696,0.283045977011494,0.716954022988506
"592",1998-11-13,193,491,0,684,0.282163742690059,0.717836257309942
"593",1998-11-20,189,497,0,686,0.275510204081633,0.724489795918367
"594",1998-11-25,179,507,0,686,0.260932944606414,0.739067055393586
"595",1998-12-04,167,502,0,669,0.249626307922272,0.750373692077728
"596",1998-12-11,169,498,0,667,0.253373313343328,0.746626686656672
"597",1998-12-18,152,489,1,642,0.236760124610592,0.761682242990654
"598",1998-12-23,149,484,1,634,0.235015772870662,0.763406940063092
"599",1998-12-30,137,483,1,621,0.22061191626409,0.777777777777778
"600",1999-01-08,133,466,1,600,0.221666666666667,0.776666666666667
"601",1999-01-15,126,470,1,597,0.21105527638191,0.787269681742044
"602",1999-01-22,122,465,1,588,0.207482993197279,0.790816326530612
"603",1999-01-29,119,443,0,562,0.211743772241993,0.788256227758007
"604",1999-02-05,125,433,0,558,0.224014336917563,0.775985663082437
"605",1999-02-12,122,422,0,544,0.224264705882353,0.775735294117647
"606",1999-02-19,111,420,0,531,0.209039548022599,0.790960451977401
"607",1999-02-26,108,425,0,533,0.202626641651032,0.797373358348968
"608",1999-03-05,115,426,0,541,0.212569316081331,0.787430683918669
"609",1999-03-12,116,418,0,534,0.217228464419476,0.782771535580524
"610",1999-03-19,114,412,0,526,0.216730038022814,0.783269961977186
"611",1999-03-26,111,391,0,502,0.221115537848606,0.778884462151394
"612",1999-04-02,121,382,0,503,0.240556660039761,0.759443339960239
"613",1999-04-09,122,376,0,498,0.244979919678715,0.755020080321285
"614",1999-04-16,130,369,0,499,0.260521042084168,0.739478957915832
"615",1999-04-23,126,362,0,488,0.258196721311475,0.741803278688525
"616",1999-04-30,126,368,0,494,0.255060728744939,0.744939271255061
"617",1999-05-07,134,371,0,505,0.265346534653465,0.734653465346535
"618",1999-05-14,142,365,0,507,0.280078895463511,0.719921104536489
"619",1999-05-21,138,380,0,518,0.266409266409266,0.733590733590734
"620",1999-05-28,130,404,0,534,0.243445692883895,0.756554307116105
"621",1999-06-04,134,421,0,555,0.241441441441441,0.758558558558559
"622",1999-06-11,136,411,0,547,0.248628884826325,0.751371115173675
"623",1999-06-18,117,449,0,566,0.206713780918728,0.793286219081272
"624",1999-06-25,110,453,0,563,0.19538188277087,0.80461811722913
"625",1999-07-02,112,467,1,580,0.193103448275862,0.805172413793103
"626",1999-07-09,120,450,0,570,0.210526315789474,0.789473684210526
"627",1999-07-16,105,476,2,583,0.180102915951973,0.816466552315609
"628",1999-07-23,102,501,2,605,0.168595041322314,0.828099173553719
"629",1999-07-30,102,498,2,602,0.169435215946844,0.827242524916944
"630",1999-08-06,98,516,2,616,0.159090909090909,0.837662337662338
"631",1999-08-13,115,510,2,627,0.18341307814992,0.813397129186603
"632",1999-08-20,112,531,2,645,0.173643410852713,0.823255813953488
"633",1999-08-27,117,550,1,668,0.175149700598802,0.823353293413174
"634",1999-09-03,121,549,1,671,0.180327868852459,0.818181818181818
"635",1999-09-10,128,561,1,690,0.185507246376812,0.81304347826087
"636",1999-09-17,132,570,1,703,0.187766714082504,0.810810810810811
"637",1999-09-24,140,580,0,720,0.194444444444444,0.805555555555556
"638",1999-10-01,131,597,2,730,0.179452054794521,0.817808219178082
"639",1999-10-08,141,599,1,741,0.190283400809717,0.808367071524966
"640",1999-10-15,140,579,2,721,0.194174757281553,0.803051317614424
"641",1999-10-22,139,609,2,750,0.185333333333333,0.812
"642",1999-10-29,136,623,2,761,0.178712220762155,0.818659658344284
"643",1999-11-05,137,624,2,763,0.179554390563565,0.817824377457405
"644",1999-11-12,150,622,2,774,0.193798449612403,0.803617571059432
"645",1999-11-19,147,648,2,797,0.18444165621079,0.813048933500627
"646",1999-11-26,146,647,2,795,0.183647798742138,0.813836477987421
"647",1999-12-03,146,648,2,796,0.183417085427136,0.814070351758794
"648",1999-12-10,158,653,2,813,0.194341943419434,0.80319803198032
"649",1999-12-17,175,638,2,815,0.214723926380368,0.782822085889571
"650",1999-12-22,162,634,1,797,0.203262233375157,0.795483061480552
"651",1999-12-30,165,606,0,771,0.214007782101167,0.785992217898833
"652",2000-01-07,158,627,1,786,0.201017811704835,0.797709923664122
"653",2000-01-14,142,638,1,781,0.181818181818182,0.816901408450704
"654",2000-01-21,140,637,0,777,0.18018018018018,0.81981981981982
"655",2000-01-28,131,624,0,755,0.173509933774834,0.826490066225166
"656",2000-02-04,133,624,0,757,0.175693527080581,0.824306472919419
"657",2000-02-11,146,616,0,762,0.191601049868766,0.808398950131234
"658",2000-02-18,153,620,0,773,0.197930142302717,0.802069857697283
"659",2000-02-25,156,604,0,760,0.205263157894737,0.794736842105263
"660",2000-03-03,181,609,0,790,0.229113924050633,0.770886075949367
"661",2000-03-10,174,594,0,768,0.2265625,0.7734375
"662",2000-03-17,168,595,1,764,0.219895287958115,0.778795811518325
"663",2000-03-24,167,600,1,768,0.217447916666667,0.78125
"664",2000-03-31,173,601,1,775,0.223225806451613,0.775483870967742
"665",2000-04-01,173,601,1,775,0.233375156838143,0.765370138017566
"666",2000-04-08,186,610,1,797,0.233375156838143,0.765370138017566
"667",2000-04-20,206,610,1,817,0.252141982864137,0.746634026927785
"668",2000-04-28,199,598,1,798,0.24937343358396,0.74937343358396
"669",2000-05-05,201,632,0,833,0.241296518607443,0.758703481392557
"670",2000-05-12,196,634,0,830,0.236144578313253,0.763855421686747
"671",2000-05-19,198,651,0,849,0.23321554770318,0.76678445229682
"672",2000-05-26,201,662,1,864,0.232638888888889,0.766203703703704
"673",2000-06-02,196,668,2,866,0.226327944572748,0.771362586605081
"674",2000-06-09,197,643,0,840,0.23452380952381,0.76547619047619
"675",2000-06-16,205,666,0,871,0.235361653272101,0.764638346727899
"676",2000-06-23,203,690,0,893,0.227323628219485,0.772676371780515
"677",2000-06-30,202,718,0,920,0.219565217391304,0.780434782608696
"678",2000-07-07,198,715,0,913,0.216867469879518,0.783132530120482
"679",2000-07-14,212,716,0,928,0.228448275862069,0.771551724137931
"680",2000-07-21,213,736,1,950,0.224210526315789,0.774736842105263
"681",2000-07-28,210,764,1,975,0.215384615384615,0.783589743589744
"682",2000-08-04,208,772,1,981,0.212028542303772,0.786952089704383
"683",2000-08-11,209,765,2,976,0.214139344262295,0.783811475409836
"684",2000-08-18,206,786,2,994,0.207243460764588,0.790744466800805
"685",2000-08-25,200,794,2,996,0.200803212851406,0.79718875502008
"686",2000-09-01,202,816,1,1019,0.198233562315996,0.800785083415113
"687",2000-09-08,201,808,3,1012,0.198616600790514,0.798418972332016
"688",2000-09-15,194,816,2,1012,0.191699604743083,0.806324110671937
"689",2000-09-22,193,803,2,998,0.193386773547094,0.804609218436874
"690",2000-09-29,207,806,2,1015,0.203940886699507,0.794088669950739
"691",2000-10-06,200,833,2,1035,0.193236714975845,0.804830917874396
"692",2000-10-13,209,836,0,1045,0.2,0.8
"693",2000-10-20,210,844,0,1054,0.199240986717268,0.800759013282733
"694",2000-10-27,228,855,1,1084,0.210332103321033,0.788745387453875
"695",2000-11-03,232,845,1,1078,0.215213358070501,0.783858998144712
"696",2000-11-10,226,840,1,1067,0.211808809746954,0.787253983130272
"697",2000-11-17,232,824,1,1057,0.219489120151372,0.779564806054872
"698",2000-11-22,244,819,1,1064,0.229323308270677,0.769736842105263
"699",2000-12-01,255,834,1,1090,0.23394495412844,0.765137614678899
"700",2000-12-08,242,844,2,1088,0.222426470588235,0.775735294117647
"701",2000-12-15,244,862,1,1107,0.220415537488708,0.778681120144535
"702",2000-12-21,235,851,1,1087,0.216191352345906,0.782888684452622
"703",2000-12-29,234,879,1,1114,0.210053859964093,0.789048473967684
"704",2001-01-05,244,862,1,1107,0.220415537488708,0.778681120144535
"705",2001-01-12,234,886,1,1121,0.208742194469224,0.790365744870651
"706",2001-01-19,240,887,1,1128,0.212765957446809,0.786347517730497
"707",2001-01-26,236,879,1,1116,0.211469534050179,0.787634408602151
"708",2001-02-02,237,900,1,1138,0.208260105448155,0.790861159929701
"709",2001-02-09,234,903,0,1137,0.205804749340369,0.794195250659631
"710",2001-02-16,242,905,0,1147,0.210985178727114,0.789014821272886
"711",2001-02-23,236,885,0,1121,0.210526315789474,0.789473684210526
"712",2001-03-02,240,910,1,1151,0.208514335360556,0.790616854908775
"713",2001-03-09,252,903,3,1158,0.217616580310881,0.77979274611399
"714",2001-03-16,249,900,2,1151,0.216333622936577,0.781928757602085
"715",2001-03-23,256,904,3,1163,0.2201203783319,0.777300085984523
"716",2001-03-30,244,946,3,1193,0.20452640402347,0.792958927074602
"717",2001-04-06,253,944,3,1200,0.210833333333333,0.786666666666667
"718",2001-04-12,254,942,2,1198,0.212020033388982,0.786310517529215
"719",2001-04-20,244,967,2,1213,0.201154163231657,0.79719703215169
"720",2001-04-27,235,975,2,1212,0.193894389438944,0.804455445544555
"721",2001-05-04,244,971,2,1217,0.200493015612161,0.797863599013969
"722",2001-05-11,236,994,2,1232,0.191558441558442,0.806818181818182
"723",2001-05-18,231,992,2,1225,0.188571428571429,0.809795918367347
"724",2001-05-25,230,1030,2,1262,0.182250396196513,0.816164817749604
"725",2001-06-01,231,1037,2,1270,0.181889763779528,0.816535433070866
"726",2001-06-08,212,1051,1,1264,0.167721518987342,0.831487341772152
"727",2001-06-15,223,1042,1,1266,0.176145339652449,0.82306477093207
"728",2001-06-22,211,1063,3,1277,0.16523101018011,0.832419733750979
"729",2001-06-29,217,1056,2,1275,0.170196078431373,0.828235294117647
"730",2001-07-06,219,1054,2,1275,0.171764705882353,0.826666666666667
"731",2001-07-13,223,1068,2,1293,0.17246713070379,0.825986078886311
"732",2001-07-20,218,1058,2,1278,0.170579029733959,0.827856025039124
"733",2001-07-27,214,1050,2,1266,0.169036334913112,0.829383886255924
"734",2001-08-03,218,1047,1,1266,0.17219589257504,0.827014218009479
"735",2001-08-10,222,1025,1,1248,0.177884615384615,0.821314102564103
"736",2001-08-17,217,1024,1,1242,0.174718196457327,0.824476650563607
"737",2001-08-24,215,1035,1,1251,0.171862509992006,0.827338129496403
"738",2001-08-31,221,1030,1,1252,0.176517571884984,0.822683706070288
"739",2001-09-07,222,993,1,1216,0.182565789473684,0.816611842105263
"740",2001-09-14,220,981,1,1202,0.183028286189684,0.816139767054909
"741",2001-09-21,223,962,1,1186,0.188026981450253,0.811129848229342
"742",2001-09-28,215,953,0,1168,0.184075342465753,0.815924657534247
"743",2001-10-05,205,936,0,1141,0.179666958808063,0.820333041191937
"744",2001-10-12,208,933,0,1141,0.182296231375986,0.817703768624014
"745",2001-10-19,192,908,0,1100,0.174545454545455,0.825454545454545
"746",2001-10-26,187,876,0,1063,0.175917215428034,0.824082784571966
"747",2001-11-02,184,874,0,1058,0.173913043478261,0.826086956521739
"748",2001-11-09,176,834,0,1010,0.174257425742574,0.825742574257426
"749",2001-11-16,173,820,0,993,0.174219536757301,0.825780463242699
"750",2001-11-21,172,814,0,986,0.174442190669371,0.825557809330629
"751",2001-11-30,167,785,0,952,0.175420168067227,0.824579831932773
"752",2001-12-07,159,769,0,928,0.171336206896552,0.828663793103448
"753",2001-12-14,150,757,0,907,0.165380374862183,0.834619625137817
"754",2001-12-21,140,741,1,882,0.158730158730159,0.840136054421769
"755",2001-12-28,137,748,2,887,0.15445321307779,0.843291995490417
"756",2002-01-04,138,744,1,883,0.156285390713477,0.842582106455266
"757",2002-01-11,136,719,1,856,0.158878504672897,0.839953271028037
"758",2002-01-18,146,722,1,869,0.16800920598389,0.83084004602992
"759",2002-01-25,144,714,1,859,0.167636786961583,0.831199068684517
"760",2002-02-01,143,709,1,853,0.167643610785463,0.831184056271981
"761",2002-02-08,144,693,1,838,0.171837708830549,0.826968973747017
"762",2002-02-15,146,668,1,815,0.179141104294479,0.819631901840491
"763",2002-02-22,144,647,1,792,0.181818181818182,0.816919191919192
"764",2002-03-01,142,639,1,782,0.181585677749361,0.817135549872123
"765",2002-03-08,144,624,1,769,0.187256176853056,0.811443433029909
"766",2002-03-15,142,610,1,753,0.188579017264276,0.810092961487384
"767",2002-03-22,144,605,1,750,0.192,0.806666666666667
"768",2002-03-28,150,609,2,761,0.197109067017083,0.800262812089356
"769",2002-04-05,145,591,2,738,0.196476964769648,0.800813008130081
"770",2002-04-12,135,610,2,747,0.180722891566265,0.816599732262383
"771",2002-04-19,134,613,2,749,0.17890520694259,0.818424566088118
"772",2002-04-26,130,634,2,766,0.169712793733681,0.827676240208877
"773",2002-05-03,134,640,2,776,0.172680412371134,0.824742268041237
"774",2002-05-10,141,669,2,812,0.173645320197044,0.823891625615764
"775",2002-05-17,131,696,2,829,0.158021712907117,0.83956574185766
"776",2002-05-24,132,725,2,859,0.153667054714785,0.844004656577416
"777",2002-05-31,131,721,2,854,0.153395784543326,0.844262295081967
"778",2002-06-07,135,710,2,847,0.159386068476978,0.838252656434475
"779",2002-06-14,134,709,1,844,0.158767772511848,0.840047393364929
"780",2002-06-21,139,698,1,838,0.165871121718377,0.832935560859189
"781",2002-06-28,142,697,1,840,0.169047619047619,0.829761904761905
"782",2002-07-03,144,716,2,862,0.167053364269142,0.830626450116009
"783",2002-07-12,135,711,2,848,0.159198113207547,0.838443396226415
"784",2002-07-19,132,725,2,859,0.153667054714785,0.844004656577416
"785",2002-07-26,119,713,1,833,0.142857142857143,0.85594237695078
"786",2002-08-02,117,729,2,848,0.137971698113208,0.859669811320755
"787",2002-08-09,127,726,1,854,0.148711943793911,0.850117096018735
"788",2002-08-16,133,718,2,853,0.155920281359906,0.841735052754982
"789",2002-08-23,124,713,1,838,0.147971360381862,0.850835322195704
"790",2002-08-30,124,721,2,847,0.146399055489965,0.851239669421488
"791",2002-09-06,116,733,2,851,0.136310223266745,0.861339600470035
"792",2002-09-13,115,746,2,863,0.133256083429896,0.864426419466976
"793",2002-09-20,125,725,2,852,0.146713615023474,0.85093896713615
"794",2002-09-27,131,741,3,875,0.149714285714286,0.846857142857143
"795",2002-10-04,142,712,3,857,0.165694282380397,0.830805134189032
"796",2002-10-11,137,709,3,849,0.161366313309776,0.83510011778563
"797",2002-10-18,137,703,3,843,0.162514827995255,0.833926453143535
"798",2002-10-25,142,710,4,856,0.16588785046729,0.829439252336449
"799",2002-11-01,158,692,4,854,0.185011709601874,0.810304449648712
"800",2002-11-08,149,673,4,826,0.180387409200969,0.814769975786925
"801",2002-11-15,147,678,5,830,0.17710843373494,0.816867469879518
"802",2002-11-22,142,679,5,826,0.171912832929782,0.822033898305085
"803",2002-11-27,135,695,5,835,0.161676646706587,0.832335329341317
"804",2002-12-06,142,705,5,852,0.166666666666667,0.827464788732394
"805",2002-12-13,133,711,6,850,0.156470588235294,0.836470588235294
"806",2002-12-20,135,719,6,860,0.156976744186047,0.836046511627907
"807",2002-12-27,136,722,4,862,0.157772621809745,0.837587006960557
"808",2003-01-03,127,706,4,837,0.151732377538829,0.843488649940263
"809",2003-01-10,129,718,4,851,0.151586368977673,0.843713278495887
"810",2003-01-17,130,712,3,845,0.153846153846154,0.842603550295858
"811",2003-01-24,133,726,3,862,0.154292343387471,0.842227378190255
"812",2003-01-31,142,728,3,873,0.162657502863688,0.833906071019473
"813",2003-02-07,146,734,4,884,0.165158371040724,0.830316742081448
"814",2003-02-14,149,752,4,905,0.164640883977901,0.830939226519337
"815",2003-02-21,157,767,4,928,0.169181034482759,0.826508620689655
"816",2003-02-28,161,747,4,912,0.176535087719298,0.819078947368421
"817",2003-03-07,169,756,4,929,0.181916038751346,0.813778256189451
"818",2003-03-14,170,754,3,927,0.183387270765912,0.813376483279396
"819",2003-03-21,167,776,3,946,0.176532769556025,0.820295983086681
"820",2003-03-28,178,781,3,962,0.185031185031185,0.811850311850312
"821",2003-04-04,187,782,3,972,0.19238683127572,0.804526748971193
"822",2003-04-11,186,790,3,979,0.189989785495403,0.806945863125638
"823",2003-04-17,186,805,3,994,0.187122736418511,0.809859154929578
"824",2003-04-25,179,804,3,986,0.181541582150101,0.815415821501014
"825",2003-05-02,174,825,2,1001,0.173826173826174,0.824175824175824
"826",2003-05-09,170,848,3,1021,0.166503428011753,0.830558276199804
"827",2003-05-16,168,868,4,1040,0.161538461538462,0.834615384615385
"828",2003-05-23,164,882,4,1050,0.156190476190476,0.84
"829",2003-05-30,160,896,3,1059,0.151085930122757,0.846081208687441
"830",2003-06-06,159,892,3,1054,0.150853889943074,0.846299810246679
"831",2003-06-13,158,910,3,1071,0.147525676937442,0.849673202614379
"832",2003-06-20,148,915,4,1067,0.138706654170572,0.857544517338332
"833",2003-06-27,144,924,6,1074,0.134078212290503,0.860335195530726
"834",2003-07-03,148,925,4,1077,0.137418755803157,0.858867223769731
"835",2003-07-11,153,908,4,1065,0.143661971830986,0.852582159624413
"836",2003-07-18,154,932,3,1089,0.141414141414141,0.855831037649219
"837",2003-07-25,158,930,3,1091,0.144821264894592,0.852428964252979
"838",2003-08-01,156,937,4,1097,0.142206016408387,0.854147675478578
"839",2003-08-08,149,920,5,1074,0.138733705772812,0.856610800744879
"840",2003-08-15,158,933,5,1096,0.144160583941606,0.851277372262774
"841",2003-08-22,149,928,5,1082,0.137707948243993,0.857670979667283
"842",2003-08-29,154,944,4,1102,0.139745916515427,0.856624319419238
"843",2003-09-05,152,937,2,1091,0.139321723189734,0.85884509624198
"844",2003-09-12,165,928,2,1095,0.150684931506849,0.847488584474886
"845",2003-09-19,152,936,4,1092,0.139194139194139,0.857142857142857
"846",2003-09-26,148,943,4,1095,0.135159817351598,0.861187214611872
"847",2003-10-03,155,932,4,1091,0.142071494042163,0.854262144821265
"848",2003-10-10,155,950,4,1109,0.139765554553652,0.856627592425609
"849",2003-10-17,160,951,4,1115,0.143497757847534,0.852914798206278
"850",2003-10-24,158,930,2,1090,0.144954128440367,0.853211009174312
"851",2003-10-31,161,944,2,1107,0.145438121047877,0.852755194218609
"852",2003-11-07,160,952,2,1114,0.143626570915619,0.854578096947935
"853",2003-11-14,161,948,2,1111,0.144914491449145,0.853285328532853
"854",2003-11-21,157,948,2,1107,0.141824751580849,0.856368563685637
"855",2003-11-26,152,959,2,1113,0.136567834681042,0.861635220125786
"856",2003-12-05,153,956,2,1111,0.137713771377138,0.86048604860486
"857",2003-12-12,148,959,2,1109,0.133453561767358,0.864743011722272
"858",2003-12-19,154,956,2,1112,0.138489208633094,0.859712230215827
"859",2003-12-23,153,959,2,1114,0.137342908438061,0.860861759425494
"860",2003-12-31,158,966,2,1126,0.140319715808171,0.857904085257549
"861",2004-01-09,147,957,2,1106,0.132911392405063,0.865280289330922
"862",2004-01-16,145,980,2,1127,0.12866015971606,0.869565217391304
"863",2004-01-23,137,946,4,1087,0.126034958601656,0.870285188592456
"864",2004-01-30,142,938,4,1084,0.1309963099631,0.865313653136531
"865",2004-02-06,144,968,5,1117,0.128916741271262,0.866606982990152
"866",2004-02-13,155,951,5,1111,0.13951395139514,0.855985598559856
"867",2004-02-20,155,954,5,1114,0.139138240574506,0.856373429084381
"868",2004-02-27,158,971,5,1134,0.139329805996473,0.85626102292769
"869",2004-03-05,161,964,4,1129,0.142604074402126,0.853852967227635
"870",2004-03-12,169,961,4,1134,0.149029982363316,0.847442680776014
"871",2004-03-19,162,963,3,1128,0.143617021276596,0.853723404255319
"872",2004-03-26,165,982,3,1150,0.143478260869565,0.853913043478261
"873",2004-04-02,157,1000,3,1160,0.135344827586207,0.862068965517241
"874",2004-04-08,148,988,2,1138,0.130052724077329,0.868189806678383
"875",2004-04-16,156,992,2,1150,0.135652173913044,0.862608695652174
"876",2004-04-23,149,996,1,1146,0.130017452006981,0.869109947643979
"877",2004-04-30,158,1002,1,1161,0.136089577950043,0.863049095607235
"878",2004-05-07,158,994,1,1153,0.137033824804857,0.862098872506505
"879",2004-05-14,157,1004,1,1162,0.135111876075732,0.864027538726334
"880",2004-05-21,153,1018,1,1172,0.130546075085324,0.868600682593857
"881",2004-05-28,156,1012,1,1169,0.133447390932421,0.865697177074423
"882",2004-06-04,159,1008,1,1168,0.136130136986301,0.863013698630137
"883",2004-06-11,162,1024,1,1187,0.13647851727043,0.86267902274642
"884",2004-06-18,163,1006,2,1171,0.139197267292912,0.859094790777114
"885",2004-06-25,170,1005,1,1176,0.144557823129252,0.854591836734694
"886",2004-07-02,168,1031,2,1201,0.139883430474605,0.858451290591174
"887",2004-07-09,177,1028,2,1207,0.146644573322287,0.851698425849213
"888",2004-07-16,168,1041,2,1211,0.138728323699422,0.85962014863749
"889",2004-07-23,168,1047,1,1216,0.138157894736842,0.861019736842105
"890",2004-07-30,171,1057,1,1229,0.139137510170871,0.860048820179007
"891",2004-08-06,170,1064,1,1235,0.137651821862348,0.861538461538462
"892",2004-08-13,168,1063,1,1232,0.136363636363636,0.862824675324675
"893",2004-08-20,174,1055,1,1230,0.141463414634146,0.857723577235772
"894",2004-08-27,169,1069,1,1239,0.136400322841001,0.862792574656981
"895",2004-09-03,166,1082,1,1249,0.132906325060048,0.866293034427542
"896",2004-09-10,170,1069,1,1240,0.137096774193548,0.862096774193548
"897",2004-09-17,163,1068,1,1232,0.132305194805195,0.866883116883117
"898",2004-09-24,165,1073,1,1239,0.13317191283293,0.866020984665053
"899",2004-10-01,161,1081,1,1243,0.129525341914722,0.869670152855994
"900",2004-10-08,169,1060,1,1230,0.13739837398374,0.861788617886179
"901",2004-10-15,167,1057,1,1225,0.136326530612245,0.862857142857143
"902",2004-10-22,178,1071,1,1250,0.1424,0.8568
"903",2004-10-29,179,1071,1,1251,0.14308553157474,0.856115107913669
"904",2004-11-05,190,1077,1,1268,0.149842271293375,0.849369085173502
"905",2004-11-12,179,1079,1,1259,0.142176330420969,0.857029388403495
"906",2004-11-19,186,1080,2,1268,0.146687697160883,0.851735015772871
"907",2004-11-24,177,1072,2,1251,0.141486810551559,0.85691446842526
"908",2004-12-03,173,1070,2,1245,0.138955823293173,0.859437751004016
"909",2004-12-10,178,1070,2,1250,0.1424,0.856
"910",2004-12-17,182,1050,2,1234,0.147487844408428,0.850891410048622
"911",2004-12-23,184,1070,3,1257,0.146380270485282,0.851233094669849
"912",2004-12-31,183,1058,2,1243,0.14722445695897,0.851166532582462
"913",2005-01-07,177,1063,2,1242,0.142512077294686,0.855877616747182
"914",2005-01-14,172,1084,2,1258,0.136724960254372,0.861685214626391
"915",2005-01-21,177,1084,2,1263,0.140142517814727,0.858273950910531
"916",2005-01-28,185,1069,2,1256,0.147292993630573,0.851114649681529
"917",2005-02-04,187,1059,2,1248,0.149839743589744,0.848557692307692
"918",2005-02-11,193,1086,1,1280,0.15078125,0.8484375
"919",2005-02-18,197,1096,2,1295,0.152123552123552,0.846332046332046
"920",2005-02-25,189,1090,2,1281,0.147540983606557,0.850897736143638
"921",2005-03-04,198,1090,2,1290,0.153488372093023,0.844961240310078
"922",2005-03-11,189,1091,2,1282,0.147425897035881,0.851014040561622
"923",2005-03-18,180,1139,1,1320,0.136363636363636,0.862878787878788
"924",2005-03-24,178,1152,1,1331,0.133734034560481,0.865514650638618
"925",2005-04-01,171,1157,1,1329,0.128668171557562,0.870579382994733
"926",2005-04-08,170,1157,0,1327,0.12810851544838,0.87189148455162
"927",2005-04-15,173,1175,0,1348,0.128338278931751,0.871661721068249
"928",2005-04-22,173,1170,0,1343,0.128816083395383,0.871183916604617
"929",2005-04-29,169,1156,0,1325,0.127547169811321,0.872452830188679
"930",2005-05-06,155,1169,0,1324,0.117069486404834,0.882930513595166
"931",2005-05-13,150,1158,0,1308,0.114678899082569,0.885321100917431
"932",2005-05-20,146,1169,0,1315,0.111026615969582,0.888973384030418
"933",2005-05-27,148,1183,0,1331,0.111194590533434,0.888805409466567
"934",2005-06-03,146,1206,1,1353,0.107908351810791,0.891352549889135
"935",2005-06-10,141,1196,2,1339,0.105302464525766,0.893203883495146
"936",2005-06-17,146,1210,2,1358,0.107511045655376,0.891016200294551
"937",2005-06-24,149,1219,2,1370,0.108759124087591,0.88978102189781
"938",2005-07-01,157,1211,2,1370,0.114598540145985,0.883941605839416
"939",2005-07-08,157,1235,2,1394,0.112625538020086,0.885939741750359
"940",2005-07-15,168,1234,2,1404,0.11965811965812,0.878917378917379
"941",2005-07-22,181,1228,1,1410,0.128368794326241,0.870921985815603
"942",2005-07-29,189,1221,2,1412,0.13385269121813,0.864730878186969
"943",2005-08-05,199,1235,2,1436,0.13857938718663,0.860027855153203
"944",2005-08-12,197,1230,2,1429,0.137858642407278,0.86074177746676
"945",2005-08-19,207,1221,5,1433,0.144452198185625,0.852058618283322
"946",2005-08-26,220,1220,4,1444,0.152354570637119,0.844875346260388
"947",2005-09-02,223,1219,5,1447,0.15411195577056,0.842432619212163
"948",2005-09-09,215,1221,5,1441,0.149201943095073,0.847328244274809
"949",2005-09-16,202,1230,4,1436,0.14066852367688,0.856545961002786
"950",2005-09-23,205,1239,7,1451,0.141281874569263,0.853893866299104
"951",2005-09-30,203,1273,7,1483,0.136884693189481,0.858395144976399
"952",2005-10-07,209,1264,8,1481,0.141120864280891,0.853477380148548
"953",2005-10-14,215,1262,5,1482,0.145074224021592,0.851551956815115
"954",2005-10-21,216,1253,5,1474,0.146540027137042,0.850067842605156
"955",2005-10-28,227,1247,6,1480,0.153378378378378,0.842567567567568
"956",2005-11-04,231,1260,5,1496,0.154411764705882,0.842245989304813
"957",2005-11-11,241,1232,6,1479,0.162947937795808,0.832995267072346
"958",2005-11-18,265,1209,4,1478,0.179296346414073,0.817997293640054
"959",2005-11-23,275,1212,4,1491,0.184439973172368,0.812877263581489
"960",2005-12-02,264,1192,4,1460,0.180821917808219,0.816438356164384
"961",2005-12-09,257,1222,4,1483,0.17329737019555,0.824005394470668
"962",2005-12-16,237,1222,4,1463,0.161995898838004,0.83526999316473
"963",2005-12-22,243,1230,2,1475,0.164745762711864,0.833898305084746
"964",2005-12-30,235,1234,2,1471,0.159755268524813,0.838885112168593
"965",2006-01-06,243,1219,2,1464,0.165983606557377,0.832650273224044
"966",2006-01-13,241,1224,2,1467,0.16428084526244,0.834355828220859
"967",2006-01-20,247,1222,3,1472,0.167798913043478,0.830163043478261
"968",2006-01-27,237,1247,3,1487,0.159381304640215,0.838601210490921
"969",2006-02-03,197,1313,3,1513,0.130204890945142,0.867812293456709
"970",2006-02-10,206,1323,3,1532,0.134464751958225,0.863577023498695
"971",2006-02-17,215,1327,3,1545,0.13915857605178,0.858899676375405
"972",2006-02-24,219,1322,2,1543,0.141931302657161,0.856772521062865
"973",2006-03-03,226,1304,1,1531,0.147615937295885,0.851730894839974
"974",2006-03-10,238,1292,2,1532,0.155352480417755,0.843342036553525
"975",2006-03-17,249,1295,2,1546,0.161060802069858,0.83764553686934
"976",2006-03-24,255,1314,2,1571,0.162316995544239,0.836409929980904
"977",2006-03-31,253,1321,2,1576,0.160532994923858,0.838197969543147
"978",2006-04-07,264,1313,2,1579,0.167194426852438,0.83153894870171
"979",2006-04-13,259,1349,2,1610,0.160869565217391,0.837888198757764
"980",2006-04-21,259,1331,1,1591,0.162790697674419,0.836580766813325
"981",2006-04-28,254,1353,1,1608,0.157960199004975,0.841417910447761
"982",2006-05-05,259,1365,1,1625,0.159384615384615,0.84
"983",2006-05-12,259,1367,1,1627,0.159188690842041,0.84019668100799
"984",2006-05-19,260,1378,1,1639,0.158633312995729,0.840756558877364
"985",2006-05-26,265,1381,3,1649,0.160703456640388,0.837477258944815
"986",2006-06-02,265,1389,3,1657,0.15992757996379,0.83826191913096
"987",2006-06-09,281,1376,4,1661,0.169175195665262,0.828416616496087
"988",2006-06-16,285,1383,4,1672,0.170454545454545,0.827153110047847
"989",2006-06-23,294,1371,4,1669,0.176153385260635,0.821449970041941
"990",2006-06-30,302,1359,5,1666,0.181272509003601,0.815726290516207
"991",2006-07-07,295,1359,5,1659,0.177817962628089,0.819168173598553
"992",2006-07-14,296,1368,4,1668,0.177458033573142,0.820143884892086
"993",2006-07-21,299,1381,3,1683,0.177658942364825,0.820558526440879
"994",2006-07-28,302,1408,4,1714,0.176196032672112,0.82147024504084
"995",2006-08-04,305,1396,4,1705,0.178885630498534,0.818768328445748
"996",2006-08-11,315,1409,4,1728,0.182291666666667,0.815393518518519
"997",2006-08-18,330,1427,5,1762,0.187287173666288,0.809875141884223
"998",2006-08-25,315,1436,5,1756,0.179384965831435,0.817767653758542
"999",2006-09-01,311,1416,5,1732,0.179561200923788,0.817551963048499
"1000",2006-09-08,310,1413,5,1728,0.179398148148148,0.817708333333333
"1001",2006-09-15,310,1422,5,1737,0.178468624064479,0.818652849740933
"1002",2006-09-22,299,1450,5,1754,0.170467502850627,0.826681870011403
"1003",2006-09-29,295,1445,4,1744,0.169151376146789,0.82855504587156
"1004",2006-10-06,288,1432,4,1724,0.167053364269142,0.830626450116009
"1005",2006-10-13,284,1439,5,1728,0.164351851851852,0.83275462962963
"1006",2006-10-20,291,1442,6,1739,0.167337550316274,0.829212190914319
"1007",2006-10-27,289,1450,5,1744,0.165711009174312,0.831422018348624
"1008",2006-11-03,291,1443,5,1739,0.167337550316274,0.829787234042553
"1009",2006-11-10,273,1415,5,1693,0.161252215002953,0.83579444772593
"1010",2006-11-17,289,1402,5,1696,0.170400943396226,0.826650943396227
"1011",2006-11-22,297,1395,5,1697,0.175014731879788,0.82203889216264
"1012",2006-12-01,289,1423,5,1717,0.168316831683168,0.828771112405358
"1013",2006-12-08,282,1437,5,1724,0.163573085846868,0.833526682134571
"1014",2006-12-15,278,1433,5,1716,0.162004662004662,0.835081585081585
"1015",2006-12-22,279,1438,6,1723,0.161926871735345,0.834590829947766
"1016",2006-12-29,278,1425,7,1710,0.162573099415205,0.833333333333333
"1017",2007-01-05,279,1411,5,1695,0.164601769911504,0.832448377581121
"1018",2007-01-12,269,1444,4,1717,0.156668608037274,0.841001747233547
"1019",2007-01-19,275,1466,4,1745,0.157593123209169,0.840114613180516
"1020",2007-01-26,255,1440,4,1699,0.150088287227781,0.847557386698058
"1021",2007-02-02,264,1446,4,1714,0.154025670945158,0.843640606767795
"1022",2007-02-09,254,1473,4,1731,0.146735990756788,0.850953206239168
"1023",2007-02-16,267,1473,6,1746,0.152920962199313,0.843642611683849
"1024",2007-02-23,278,1472,4,1754,0.158494868871152,0.839224629418472
"1025",2007-03-02,290,1458,4,1752,0.165525114155251,0.832191780821918
"1026",2007-03-09,287,1465,5,1757,0.163346613545817,0.833807626636312
"1027",2007-03-16,282,1453,5,1740,0.162068965517241,0.835057471264368
"1028",2007-03-23,281,1459,5,1745,0.161031518624642,0.836103151862464
"1029",2007-03-30,271,1472,6,1749,0.15494568324757,0.841623785020012
"1030",2007-04-06,283,1438,5,1726,0.16396292004635,0.833140208574739
"1031",2007-04-13,282,1472,4,1758,0.160409556313993,0.837315130830489
"1032",2007-04-20,292,1473,4,1769,0.165065008479367,0.832673827020916
"1033",2007-04-27,283,1460,4,1747,0.161991986262164,0.835718374356039
"1034",2007-05-04,282,1462,3,1747,0.161419576416714,0.836863194046938
"1035",2007-05-11,282,1456,2,1740,0.162068965517241,0.836781609195402
"1036",2007-05-18,276,1466,2,1744,0.158256880733945,0.840596330275229
"1037",2007-05-25,287,1471,2,1760,0.163068181818182,0.835795454545455
"1038",2007-06-01,288,1484,2,1774,0.162344983089064,0.836527621195039
"1039",2007-06-08,291,1465,4,1760,0.165340909090909,0.832386363636364
"1040",2007-06-15,285,1484,4,1773,0.160744500846024,0.836999435984208
"1041",2007-06-22,271,1495,5,1771,0.153020892151327,0.844155844155844
"1042",2007-06-29,281,1489,5,1775,0.15830985915493,0.83887323943662
"1043",2007-07-06,274,1473,5,1752,0.156392694063927,0.840753424657534
"1044",2007-07-13,284,1501,6,1791,0.15857063093244,0.838079285315466
"1045",2007-07-20,287,1497,6,1790,0.160335195530726,0.836312849162011
"1046",2007-07-27,296,1474,5,1775,0.166760563380282,0.830422535211268
"1047",2007-08-03,306,1470,5,1781,0.171813587871982,0.825379000561482
"1048",2007-08-10,305,1487,6,1798,0.169632925472748,0.827030033370412
"1049",2007-08-17,309,1480,6,1795,0.172144846796657,0.824512534818942
"1050",2007-08-24,310,1500,6,1816,0.170704845814978,0.825991189427313
"1051",2007-08-31,300,1523,6,1829,0.164024056861673,0.832695462001094
"1052",2007-09-07,294,1514,6,1814,0.162072767364939,0.834619625137817
"1053",2007-09-14,298,1483,6,1787,0.166759932848349,0.82988248461108
"1054",2007-09-21,305,1458,6,1769,0.172413793103448,0.824194460146976
"1055",2007-09-28,311,1443,6,1760,0.176704545454545,0.819886363636364
"1056",2007-10-05,318,1431,6,1755,0.181196581196581,0.815384615384615
"1057",2007-10-12,319,1442,6,1767,0.180531975099038,0.816072439162422
"1058",2007-10-19,320,1438,6,1764,0.18140589569161,0.815192743764172
"1059",2007-10-26,326,1428,6,1760,0.185227272727273,0.811363636363636
"1060",2007-11-02,335,1455,5,1795,0.186629526462396,0.81058495821727
"1061",2007-11-09,337,1459,5,1801,0.187118267629095,0.810105496946141
"1062",2007-11-16,337,1455,5,1797,0.187534780189204,0.809682804674457
"1063",2007-11-21,343,1424,6,1773,0.193457416807671,0.803158488437676
"1064",2007-11-30,354,1463,6,1823,0.194185408667032,0.802523313219967
"1065",2007-12-07,340,1482,6,1828,0.185995623632385,0.810722100656455
"1066",2007-12-14,342,1477,5,1824,0.1875,0.809758771929825
"1067",2007-12-21,343,1461,5,1809,0.189607517965727,0.807628524046435
"1068",2007-12-28,325,1452,5,1782,0.182379349046016,0.814814814814815
"1069",2008-01-04,316,1450,8,1774,0.178128523111612,0.817361894024803
"1070",2008-01-11,327,1409,8,1744,0.1875,0.807912844036697
"1071",2008-01-18,323,1401,8,1732,0.1864896073903,0.808891454965358
"1072",2008-01-25,318,1422,7,1747,0.182026330852891,0.813966800228964
"1073",2008-02-01,324,1432,7,1763,0.183777651730006,0.812251843448667
"1074",2008-02-08,324,1424,7,1755,0.184615384615385,0.811396011396011
"1075",2008-02-15,339,1428,6,1773,0.191201353637902,0.805414551607445
"1076",2008-02-22,333,1430,8,1771,0.188029361942405,0.807453416149068
"1077",2008-02-29,337,1418,8,1763,0.191151446398185,0.804310833806012
"1078",2008-03-07,337,1456,9,1802,0.187014428412875,0.807991120976693
"1079",2008-03-14,343,1441,8,1792,0.19140625,0.804129464285714
"1080",2008-03-21,341,1433,10,1784,0.191143497757848,0.803251121076233
"1081",2008-03-28,350,1447,11,1808,0.19358407079646,0.80033185840708
"1082",2008-04-04,362,1458,10,1830,0.197814207650273,0.79672131147541
"1083",2008-04-11,355,1451,9,1815,0.195592286501377,0.799449035812672
"1084",2008-04-18,355,1461,11,1827,0.194307608100712,0.799671592775041
"1085",2008-04-25,360,1473,9,1842,0.195439739413681,0.799674267100977
"1086",2008-05-02,357,1473,9,1839,0.194127243066884,0.800978792822186
"1087",2008-05-09,361,1475,10,1846,0.195557963163597,0.799024918743229
"1088",2008-05-16,381,1471,10,1862,0.204618689581096,0.790010741138561
"1089",2008-05-23,386,1493,10,1889,0.204340921122287,0.790365272631022
"1090",2008-05-30,390,1479,8,1877,0.207778369738945,0.787959509856154
"1091",2008-06-06,385,1493,8,1886,0.204135737009544,0.791622481442206
"1092",2008-06-13,389,1504,8,1901,0.204629142556549,0.791162546028406
"1093",2008-06-20,384,1514,8,1906,0.201469045120672,0.794333683105981
"1094",2008-06-27,375,1530,8,1913,0.196027182435964,0.799790904338735
"1095",2008-07-04,373,1539,9,1921,0.194169703279542,0.801145236855804
"1096",2008-07-11,370,1544,8,1922,0.192507804370447,0.803329864724246
"1097",2008-07-18,385,1534,9,1928,0.199688796680498,0.795643153526971
"1098",2008-07-25,393,1555,9,1957,0.200817577925396,0.794583546244251
"1099",2008-08-01,392,1550,9,1951,0.200922603792927,0.79446437724244
"1100",2008-08-08,387,1571,9,1967,0.196746314184037,0.798678190137265
"1101",2008-08-15,395,1586,9,1990,0.198492462311558,0.796984924623116
"1102",2008-08-22,395,1594,9,1998,0.197697697697698,0.797797797797798
"1103",2008-08-29,416,1606,9,2031,0.204825209256524,0.790743476120138
"1104",2008-09-05,416,1586,11,2013,0.206656731246895,0.787878787878788
"1105",2008-09-12,413,1606,12,2031,0.203348104382078,0.790743476120138
"1106",2008-09-19,417,1589,12,2018,0.206640237859267,0.787413280475719
"1107",2008-09-26,423,1559,13,1995,0.21203007518797,0.781453634085213
"1108",2008-10-03,422,1544,13,1979,0.213239009600809,0.780192016169783
"1109",2008-10-10,429,1548,13,1990,0.215577889447236,0.777889447236181
"1110",2008-10-17,428,1537,11,1976,0.216599190283401,0.777834008097166
"1111",2008-10-24,423,1529,12,1964,0.215376782077393,0.778513238289206
"1112",2008-10-31,408,1552,11,1971,0.207001522070015,0.787417554540842
"1113",2008-11-07,442,1539,11,1992,0.221887550200803,0.772590361445783
"1114",2008-11-14,429,1498,14,1941,0.221020092735703,0.771767130345183
"1115",2008-11-21,419,1511,11,1941,0.215868109222051,0.778464708912932
"1116",2008-11-26,412,1443,11,1866,0.220793140407288,0.773311897106109
"1117",2008-12-05,413,1428,11,1852,0.223002159827214,0.771058315334773
"1118",2008-12-12,401,1379,10,1790,0.224022346368715,0.770391061452514
"1119",2008-12-19,387,1366,11,1764,0.219387755102041,0.77437641723356
"1120",2008-12-26,364,1347,10,1721,0.21150493898896,0.782684485764091
"1121",2009-01-02,346,1267,10,1623,0.213185459026494,0.780653111521873
"1122",2009-01-09,341,1239,9,1589,0.214600377595972,0.779735682819383
"1123",2009-01-16,324,1235,9,1568,0.206632653061225,0.787627551020408
"1124",2009-01-23,318,1185,12,1515,0.20990099009901,0.782178217821782
"1125",2009-01-30,309,1150,13,1472,0.20991847826087,0.78125
"1126",2009-02-06,283,1104,12,1399,0.20228734810579,0.789135096497498
"1127",2009-02-13,273,1054,12,1339,0.203883495145631,0.787154592979836
"1128",2009-02-20,269,1018,13,1300,0.206923076923077,0.783076923076923
"1129",2009-02-27,260,970,13,1243,0.209171359613837,0.780370072405471
"1130",2009-03-06,241,916,13,1170,0.205982905982906,0.782905982905983
"1131",2009-03-13,228,884,14,1126,0.202486678507993,0.785079928952043
"1132",2009-03-20,215,857,13,1085,0.19815668202765,0.789861751152074
"1133",2009-03-27,217,810,12,1039,0.208854667949952,0.779595765158807
"1134",2009-04-03,224,808,11,1043,0.214765100671141,0.774688398849473
"1135",2009-04-04,224,808,11,1043,0.214765100671141,0.774688398849473
"1136",2009-04-17,205,760,10,975,0.21025641025641,0.77948717948718
"1137",2009-04-24,202,742,11,955,0.21151832460733,0.77696335078534
"1138",2009-05-01,196,741,8,945,0.207407407407407,0.784126984126984
"1139",2009-05-08,190,730,8,928,0.204741379310345,0.786637931034483
"1140",2009-05-15,181,728,9,918,0.197167755991285,0.793028322440087
"1141",2009-05-22,180,711,9,900,0.2,0.79
"1142",2009-05-29,187,703,9,899,0.208008898776418,0.781979977753059
"1143",2009-06-05,179,700,8,887,0.201803833145434,0.789177001127396
"1144",2009-06-12,183,685,8,876,0.208904109589041,0.781963470319635
"1145",2009-06-19,196,692,11,899,0.218020022246941,0.769744160177976
"1146",2009-06-26,219,687,11,917,0.238822246455834,0.749182115594329
"1147",2009-07-02,229,688,11,928,0.24676724137931,0.741379310344828
"1148",2009-07-10,234,672,10,916,0.255458515283843,0.733624454148472
"1149",2009-07-17,244,665,11,920,0.265217391304348,0.722826086956522
"1150",2009-07-24,257,675,11,943,0.27253446447508,0.715800636267232
"1151",2009-07-31,261,677,10,948,0.275316455696203,0.714135021097046
"1152",2009-08-07,277,681,8,966,0.286749482401656,0.704968944099379
"1153",2009-08-14,272,688,8,968,0.28099173553719,0.710743801652893
"1154",2009-08-21,280,695,10,985,0.284263959390863,0.705583756345178
"1155",2009-08-28,286,699,14,999,0.286286286286286,0.6996996996997
"1156",2009-09-04,295,701,13,1009,0.292368681863231,0.694747274529237
"1157",2009-09-11,288,699,12,999,0.288288288288288,0.6996996996997
"1158",2009-09-18,293,705,12,1010,0.29009900990099,0.698019801980198
"1159",2009-09-25,297,710,10,1017,0.292035398230089,0.698131760078663
"1160",2009-10-02,303,712,9,1024,0.2958984375,0.6953125
"1161",2009-10-09,305,726,10,1041,0.292987512007685,0.697406340057637
"1162",2009-10-16,309,721,10,1040,0.297115384615385,0.693269230769231
"1163",2009-10-23,312,725,11,1048,0.297709923664122,0.691793893129771
"1164",2009-10-30,330,728,11,1069,0.308699719363892,0.681010289990646
"1165",2009-11-06,332,734,12,1078,0.307977736549165,0.680890538033395
"1166",2009-11-13,361,728,12,1101,0.327883742052679,0.661217075386013
"1167",2009-11-20,375,726,12,1113,0.336927223719677,0.652291105121294
"1168",2009-11-25,379,748,10,1137,0.333333333333333,0.657871591908531
"1169",2009-12-04,383,748,10,1141,0.33567046450482,0.655565293602104
"1170",2009-12-11,393,757,11,1161,0.338501291989664,0.652024117140396
"1171",2009-12-18,409,773,11,1193,0.342833193629505,0.647946353730092
"1172",2009-12-23,416,751,11,1178,0.353140916808149,0.637521222410866
"1173",2009-12-31,418,759,12,1189,0.351555929352397,0.638351555929352
"1174",2010-01-08,427,781,12,1220,0.35,0.64016393442623
"1175",2010-01-15,425,811,12,1248,0.340544871794872,0.649839743589744
"1176",2010-01-22,437,833,12,1282,0.340873634945398,0.649765990639626
"1177",2010-01-29,444,861,12,1317,0.337129840546697,0.65375854214123
"1178",2010-02-05,445,878,12,1335,0.333333333333333,0.657677902621723
"1179",2010-02-12,443,891,12,1346,0.329123328380386,0.661961367013373
"1180",2010-02-19,440,893,12,1345,0.327137546468402,0.663940520446097
"1181",2010-02-26,456,905,12,1373,0.332119446467589,0.659140568099053
"1182",2010-03-05,456,926,14,1396,0.326647564469914,0.663323782234957
"1183",2010-03-12,466,927,14,1407,0.331201137171286,0.658848614072495
"1184",2010-03-19,474,939,14,1427,0.332165381920112,0.65802382620883
"1185",2010-03-26,489,941,14,1444,0.338642659279778,0.651662049861496
"1186",2010-04-01,502,949,14,1465,0.342662116040956,0.64778156996587
"1187",2010-04-09,505,959,12,1476,0.342140921409214,0.649728997289973
"1188",2010-04-16,506,973,12,1491,0.339369550637156,0.652582159624413
"1189",2010-04-23,514,956,12,1482,0.346828609986505,0.645074224021592
"1190",2010-04-30,513,958,12,1483,0.345920431557653,0.645987862440998
"1191",2010-05-07,528,953,11,1492,0.353887399463807,0.638739946380697
"1192",2010-05-14,544,951,11,1506,0.361221779548473,0.631474103585657
"1193",2010-05-21,538,969,11,1518,0.354413702239789,0.638339920948617
"1194",2010-05-28,555,967,13,1535,0.361563517915309,0.629967426710098
"1195",2010-06-04,545,947,14,1506,0.361885790172643,0.628818061088977
"1196",2010-06-11,561,954,12,1527,0.367387033398821,0.62475442043222
"1197",2010-06-18,574,953,12,1539,0.372969460688759,0.619233268356075
"1198",2010-06-25,583,958,11,1552,0.375644329896907,0.617268041237113
"1199",2010-07-02,587,960,10,1557,0.377007064868337,0.616570327552987
"1200",2010-07-09,592,964,11,1567,0.377791959157626,0.615188257817486
"1201",2010-07-16,580,979,12,1571,0.369191597708466,0.623169955442393
"1202",2010-07-23,591,982,12,1585,0.372870662460568,0.619558359621451
"1203",2010-07-30,603,972,11,1586,0.380201765447667,0.612862547288777
"1204",2010-08-06,611,983,11,1605,0.380685358255452,0.612461059190031
"1205",2010-08-13,636,992,12,1640,0.387804878048781,0.604878048780488
"1206",2010-08-20,655,985,11,1651,0.396729254996972,0.596608116293156
"1207",2010-08-27,672,973,11,1656,0.405797101449275,0.58756038647343
"1208",2010-09-03,665,977,11,1653,0.402298850574713,0.591046581972172
"1209",2010-09-10,663,980,11,1654,0.400846432889964,0.592503022974607
"1210",2010-09-17,670,982,9,1661,0.403371462974112,0.591210114388922
"1211",2010-09-24,673,967,10,1650,0.407878787878788,0.586060606060606
"1212",2010-10-01,687,962,10,1659,0.414104882459313,0.579867389993972
"1213",2010-10-08,690,971,10,1671,0.412926391382406,0.581089168162777
"1214",2010-10-15,695,966,9,1670,0.416167664670659,0.578443113772455
"1215",2010-10-22,695,965,9,1669,0.416417016177352,0.578190533253445
"1216",2010-10-29,696,967,9,1672,0.416267942583732,0.578349282296651
"1217",2010-11-05,718,955,10,1683,0.426619132501485,0.567439096850862
"1218",2010-11-12,720,955,10,1685,0.427299703264095,0.566765578635015
"1219",2010-11-19,731,936,10,1677,0.435897435897436,0.558139534883721
"1220",2010-11-24,724,953,10,1687,0.429164196799052,0.564908120924718
"1221",2010-12-03,742,961,10,1713,0.433158201984822,0.561004086398132
"1222",2010-12-10,763,948,12,1723,0.442832269297737,0.550203134068485
"1223",2010-12-17,756,941,12,1709,0.442363955529549,0.55061439438268
"1224",2010-12-22,771,931,12,1714,0.449824970828471,0.543173862310385
"1225",2010-12-30,765,919,10,1694,0.45159386068477,0.542502951593861
"1226",2011-01-07,777,914,9,1700,0.457058823529412,0.537647058823529
"1227",2011-01-14,789,902,9,1700,0.464117647058824,0.530588235294118
"1228",2011-01-21,798,906,9,1713,0.46584938704028,0.528896672504378
"1229",2011-01-28,809,913,10,1732,0.467090069284065,0.527136258660508
"1230",2011-02-04,818,911,10,1739,0.470385278895917,0.523864289821737
"1231",2011-02-11,805,906,10,1721,0.467751307379431,0.52643811737362
"1232",2011-02-18,798,905,10,1713,0.46584938704028,0.528312901342674
"1233",2011-02-25,783,906,10,1699,0.460859329017069,0.533254855797528
"1234",2011-03-04,801,899,7,1707,0.469244288224956,0.526654950205038
"1235",2011-03-11,827,882,6,1715,0.482215743440233,0.514285714285714
"1236",2011-03-18,839,875,6,1720,0.487790697674419,0.508720930232558
"1237",2011-03-25,851,880,7,1738,0.489643268124281,0.506329113924051
"1238",2011-04-01,877,891,8,1776,0.493806306306306,0.501689189189189
"1239",2011-04-08,886,889,7,1782,0.497194163860831,0.498877665544332
"1240",2011-04-15,880,885,7,1772,0.496613995485327,0.499435665914221
"1241",2011-04-21,913,878,9,1800,0.507222222222222,0.487777777777778
"1242",2011-04-29,926,882,10,1818,0.509350935093509,0.485148514851485
"1243",2011-05-06,934,890,12,1836,0.508714596949891,0.484749455337691
"1244",2011-05-13,947,874,9,1830,0.517486338797814,0.477595628415301
"1245",2011-05-20,954,866,10,1830,0.521311475409836,0.473224043715847
"1246",2011-05-27,958,881,8,1847,0.518678938819708,0.476989713048186
"1247",2011-06-03,959,887,8,1854,0.517259978425027,0.478425026968716
"1248",2011-06-10,969,879,7,1855,0.522371967654987,0.473854447439353
"1249",2011-06-17,984,870,6,1860,0.529032258064516,0.467741935483871
"1250",2011-06-24,1003,873,6,1882,0.532943676939426,0.463868225292242
"1251",2011-07-01,1006,874,6,1886,0.533404029692471,0.463414634146342
"1252",2011-07-08,1007,873,7,1887,0.533651298357181,0.462639109697933
"1253",2011-07-15,1013,885,7,1905,0.531758530183727,0.464566929133858
"1254",2011-07-22,1021,889,6,1916,0.532881002087683,0.463987473903967
"1255",2011-07-29,1025,877,6,1908,0.537211740041929,0.459643605870021
"1256",2011-08-05,1031,883,6,1920,0.536979166666667,0.459895833333333
"1257",2011-08-12,1055,896,8,1959,0.538540071465033,0.457376212353241
"1258",2011-08-19,1066,900,8,1974,0.540020263424519,0.455927051671733
"1259",2011-08-26,1069,898,8,1975,0.54126582278481,0.454683544303798
"1260",2011-09-02,1064,895,9,1968,0.540650406504065,0.454776422764228
"1261",2011-09-09,1057,892,9,1958,0.539836567926456,0.455566905005107
"1262",2011-09-16,1062,912,11,1985,0.535012594458438,0.459445843828715
"1263",2011-09-23,1071,912,8,1991,0.537920642893019,0.458061275740834
"1264",2011-09-30,1060,923,7,1990,0.532663316582915,0.463819095477387
"1265",2011-10-07,1070,935,7,2012,0.531809145129225,0.464711729622266
"1266",2011-10-14,1080,936,7,2023,0.533860603064755,0.462679189322788
"1267",2011-10-21,1079,927,7,2013,0.536015896671634,0.460506706408346
"1268",2011-10-28,1078,934,9,2021,0.533399307273627,0.462147451756556
"1269",2011-11-04,1112,907,7,2026,0.548864758144126,0.447680157946693
"1270",2011-11-11,1133,877,6,2016,0.562003968253968,0.435019841269841
"1271",2011-11-18,1125,871,5,2001,0.562218890554723,0.43528235882059
"1272",2011-11-25,1130,865,5,2000,0.565,0.4325
"1273",2011-12-02,1132,856,5,1993,0.567987957852484,0.429503261414952
"1274",2011-12-09,1161,820,6,1987,0.584297936587821,0.412682435832914
"1275",2011-12-16,1196,818,5,2019,0.592372461614661,0.405151064883606
"1276",2011-12-22,1201,802,5,2008,0.598107569721116,0.399402390438247
"1277",2011-12-29,1193,809,5,2007,0.594419531639263,0.403089187842551
"1278",2012-01-06,1191,811,5,2007,0.593423019431988,0.404085700049826
"1279",2012-01-13,1191,791,5,1987,0.599396074484147,0.398087569199799
"1280",2012-01-20,1223,780,5,2008,0.60906374501992,0.388446215139442
"1281",2012-01-27,1225,777,6,2008,0.610059760956175,0.38695219123506
"1282",2012-02-03,1245,745,7,1997,0.623435152729094,0.373059589384076
"1283",2012-02-10,1263,720,6,1989,0.63499245852187,0.361990950226244
"1284",2012-02-17,1272,716,6,1994,0.637913741223671,0.359077231695085
"1285",2012-02-24,1265,710,6,1981,0.638566380615851,0.358404846037355
"1286",2012-03-02,1293,691,5,1989,0.650075414781297,0.347410759175465
"1287",2012-03-09,1296,670,7,1973,0.656867714140902,0.339584389254942
"1288",2012-03-16,1317,663,4,1984,0.663810483870968,0.334173387096774
"1289",2012-03-23,1313,652,3,1968,0.667174796747967,0.33130081300813
"1290",2012-03-30,1318,658,3,1979,0.665992925720061,0.332491157150076
"1291",2012-04-05,1329,647,3,1979,0.67155128852956,0.326932794340576
"1292",2012-04-13,1322,624,4,1950,0.677948717948718,0.32
"1293",2012-04-20,1337,631,4,1972,0.677991886409736,0.319979716024341
"1294",2012-04-27,1328,613,4,1945,0.682776349614396,0.315167095115681
"1295",2012-05-04,1355,606,4,1965,0.689567430025445,0.308396946564886
"1296",2012-05-11,1372,598,4,1974,0.695035460992908,0.302938196555218
"1297",2012-05-18,1382,600,4,1986,0.695871097683787,0.302114803625378
"1298",2012-05-25,1383,594,6,1983,0.697428139183056,0.299546142208775
"1299",2012-06-01,1386,588,6,1980,0.7,0.296969696969697
"1300",2012-06-08,1414,565,5,1984,0.712701612903226,0.284778225806452
"1301",2012-06-15,1405,562,4,1971,0.712836123795028,0.285134449518011
"1302",2012-06-22,1421,541,4,1966,0.722787385554425,0.275178026449644
"1303",2012-06-29,1421,534,4,1959,0.725370086778969,0.272588055130168
"1304",2012-07-06,1419,542,4,1965,0.722137404580153,0.275826972010178
"1305",2012-07-13,1427,522,4,1953,0.730670762928828,0.267281105990783
"1306",2012-07-20,1414,518,3,1935,0.730749354005168,0.267700258397933
"1307",2012-07-27,1416,505,3,1924,0.735966735966736,0.262474012474013
"1308",2012-08-03,1429,498,3,1930,0.740414507772021,0.258031088082902
"1309",2012-08-10,1432,495,4,1931,0.741584671154842,0.256343863283273
"1310",2012-08-17,1425,484,5,1914,0.744514106583072,0.252873563218391
"1311",2012-08-24,1408,486,4,1898,0.741833508956797,0.256059009483667
"1312",2012-08-31,1419,473,2,1894,0.749208025343189,0.24973600844773
"1313",2012-09-07,1409,452,3,1864,0.755901287553648,0.242489270386266
"1314",2012-09-14,1413,448,3,1864,0.758047210300429,0.240343347639485
"1315",2012-09-21,1402,454,3,1859,0.754168908015062,0.244217321140398
"1316",2012-09-28,1410,435,3,1848,0.762987012987013,0.23538961038961
"1317",2012-10-05,1398,437,2,1837,0.761023407729995,0.237887860642352
"1318",2012-10-12,1411,422,2,1835,0.768937329700273,0.229972752043597
"1319",2012-10-19,1410,427,2,1839,0.766721044045677,0.232191408374116
"1320",2012-10-26,1408,416,2,1826,0.771084337349398,0.227820372398686
"1321",2012-11-02,1373,424,3,1800,0.762777777777778,0.235555555555556
"1322",2012-11-09,1389,413,4,1806,0.769102990033223,0.228682170542636
"1323",2012-11-16,1390,417,2,1809,0.768380320619127,0.230514096185738
"1324",2012-11-21,1388,428,1,1817,0.763896532746285,0.235553109521189
"1325",2012-11-30,1386,424,1,1811,0.765323025952512,0.234124792932082
"1326",2012-12-07,1382,417,1,1800,0.767777777777778,0.231666666666667
"1327",2012-12-14,1381,416,2,1799,0.767648693718733,0.23123957754308
"1328",2012-12-21,1340,429,5,1774,0.755355129650507,0.241826381059752
"1329",2012-12-28,1327,431,5,1763,0.752694271128758,0.244469653998866
"1330",2013-01-04,1318,439,5,1762,0.748013620885358,0.249148694665153
"1331",2013-01-11,1323,434,4,1761,0.751277683134583,0.246450880181715
"1332",2013-01-18,1316,429,4,1749,0.75242995997713,0.245283018867925
"1333",2013-01-25,1315,434,4,1753,0.750142612664005,0.247575584711922
"1334",2013-02-01,1332,428,4,1764,0.755102040816327,0.242630385487528
"1335",2013-02-08,1330,425,4,1759,0.756111426947129,0.241614553723707
"1336",2013-02-15,1337,421,4,1762,0.758796821793417,0.238933030646992
"1337",2013-02-22,1329,428,4,1761,0.754684838160136,0.243043725156161
"1338",2013-03-01,1333,420,4,1757,0.758679567444508,0.239043824701195
"1339",2013-03-08,1341,407,4,1752,0.76541095890411,0.232305936073059
"1340",2013-03-15,1341,431,4,1776,0.755067567567568,0.24268018018018
"1341",2013-03-22,1324,418,4,1746,0.758304696449026,0.239404352806415
"1342",2013-03-28,1354,389,5,1748,0.774599542334096,0.22254004576659
"1343",2013-04-05,1357,375,6,1738,0.78078250863061,0.215765247410817
"1344",2013-04-12,1387,377,7,1771,0.78317334839074,0.2128740824393
"1345",2013-04-19,1371,379,8,1758,0.779863481228669,0.215585893060296
"1346",2013-04-26,1381,366,7,1754,0.787343215507412,0.20866590649943
"1347",2013-05-03,1403,354,7,1764,0.795351473922903,0.200680272108844
"1348",2013-05-10,1412,350,7,1769,0.798191068400226,0.197851893725269
"1349",2013-05-17,1408,354,7,1769,0.795929903900509,0.200113058224986
"1350",2013-05-24,1402,354,6,1762,0.795686719636776,0.200908059023837
"1351",2013-05-31,1410,354,7,1771,0.796160361377753,0.199887069452287
"1352",2013-06-07,1406,354,5,1765,0.796600566572238,0.20056657223796
"1353",2013-06-14,1413,353,5,1771,0.79785431959345,0.199322416713721
"1354",2013-06-21,1405,349,5,1759,0.79874928936896,0.198408186469585
"1355",2013-06-28,1390,353,5,1748,0.795194508009153,0.201945080091533
"1356",2013-07-03,1395,355,7,1757,0.793966989186113,0.202048947068867
"1357",2013-07-12,1391,362,6,1759,0.790790221716885,0.205798749289369
"1358",2013-07-19,1395,369,6,1770,0.788135593220339,0.208474576271186
"1359",2013-07-26,1401,369,6,1776,0.788851351351351,0.20777027027027
"1360",2013-08-02,1388,388,6,1782,0.778900112233446,0.217732884399551
"1361",2013-08-09,1385,386,7,1778,0.77896512935883,0.217097862767154
"1362",2013-08-16,1397,388,6,1791,0.78001116694584,0.216638749302066
"1363",2013-08-23,1382,387,7,1776,0.778153153153153,0.217905405405405
"1364",2013-08-30,1388,380,8,1776,0.781531531531532,0.213963963963964
"1365",2013-09-06,1365,394,8,1767,0.772495755517827,0.222976796830787
"1366",2013-09-13,1361,401,6,1768,0.769796380090498,0.226809954751131
"1367",2013-09-20,1369,386,6,1761,0.777399204997161,0.219193639977286
"1368",2013-09-27,1362,376,6,1744,0.780963302752294,0.215596330275229
"1369",2013-10-04,1372,378,6,1756,0.781321184510251,0.215261958997722
"1370",2013-10-11,1367,369,7,1743,0.784279977051061,0.211703958691911
"1371",2013-10-18,1361,372,6,1739,0.782633697527315,0.213916043703278
"1372",2013-10-25,1357,376,5,1738,0.78078250863061,0.216340621403913
"1373",2013-11-01,1376,360,6,1742,0.789896670493685,0.206659012629162
"1374",2013-11-08,1383,365,6,1754,0.7884834663626,0.208095781071836
"1375",2013-11-15,1385,370,7,1762,0.786038592508513,0.209988649262202
"1376",2013-11-22,1387,369,5,1761,0.787620670073822,0.20954003407155
"1377",2013-11-27,1391,367,5,1763,0.788996029495179,0.208167895632445
"1378",2013-12-06,1397,375,3,1775,0.787042253521127,0.211267605633803
"1379",2013-12-13,1411,369,2,1782,0.791806958473625,0.207070707070707
"1380",2013-12-20,1395,372,1,1768,0.789027149321267,0.210407239819005
"1381",2013-12-27,1382,374,1,1757,0.786568013659647,0.212862834376779
"1382",2014-01-03,1378,372,1,1751,0.78697886921759,0.212450028555111
"1383",2014-01-10,1393,357,4,1754,0.794184720638541,0.203534777651083
"1384",2014-01-17,1408,365,4,1777,0.792346651660101,0.205402363534046
"1385",2014-01-24,1416,356,5,1777,0.796848621271806,0.200337647720878
"1386",2014-01-31,1422,358,5,1785,0.796638655462185,0.200560224089636
"1387",2014-02-07,1416,351,4,1771,0.799548277809147,0.19819311123659
"1388",2014-02-14,1423,337,4,1764,0.806689342403628,0.191043083900227
"1389",2014-02-21,1425,342,4,1771,0.804630152456239,0.193111236589497
"1390",2014-02-28,1430,335,4,1769,0.808366308648954,0.189372526851328
"1391",2014-03-07,1443,345,4,1792,0.805245535714286,0.192522321428571
"1392",2014-03-14,1461,344,4,1809,0.807628524046435,0.190160309563295
"1393",2014-03-21,1473,326,4,1803,0.816971713810316,0.180809761508597
"1394",2014-03-28,1487,318,4,1809,0.822001105583195,0.175787728026534
"1395",2014-04-04,1498,316,4,1818,0.823982398239824,0.173817381738174
"1396",2014-04-11,1517,310,4,1831,0.828509011469143,0.169306389950847
"1397",2014-04-17,1510,316,5,1831,0.824685963954123,0.172583287820863
"1398",2014-04-25,1534,323,4,1861,0.824288017195056,0.173562600752284
"1399",2014-05-02,1527,323,4,1854,0.823624595469256,0.174217907227616
"1400",2014-05-09,1528,323,4,1855,0.823719676549865,0.174123989218329
"1401",2014-05-16,1531,326,4,1861,0.822675980655562,0.175174637291779
"1402",2014-05-23,1528,325,4,1857,0.822832525578891,0.175013462574044
"1403",2014-05-30,1536,326,4,1866,0.823151125401929,0.17470525187567
"1404",2014-06-06,1536,320,4,1860,0.825806451612903,0.172043010752688
"1405",2014-06-13,1542,310,2,1854,0.831715210355987,0.167206040992449
"1406",2014-06-20,1545,311,2,1858,0.831539289558665,0.167384284176534
"1407",2014-06-27,1558,314,1,1873,0.831820608649226,0.167645488521089
"1408",2014-07-03,1562,311,1,1874,0.833511205976521,0.165955176093917
"1409",2014-07-11,1563,311,1,1875,0.8336,0.165866666666667
"1410",2014-07-18,1554,315,2,1871,0.830571886691609,0.168359166221272
"1411",2014-07-25,1562,318,3,1883,0.829527349973447,0.168879447689857
"1412",2014-08-01,1573,313,3,1889,0.832715722604553,0.16569613552144
"1413",2014-08-08,1588,316,4,1908,0.832285115303983,0.165618448637317
"1414",2014-08-15,1589,321,3,1913,0.830632514375327,0.167799268165186
"1415",2014-08-22,1564,330,2,1896,0.824894514767933,0.174050632911392
"1416",2014-08-29,1575,338,1,1914,0.822884012539185,0.176593521421108
"1417",2014-09-05,1584,340,1,1925,0.822857142857143,0.176623376623377
"1418",2014-09-12,1592,338,1,1931,0.824443293630243,0.175038839979285
"1419",2014-09-19,1601,329,1,1931,0.829104091144485,0.170378042465044
"1420",2014-09-26,1592,338,1,1931,0.824443293630243,0.175038839979285
"1421",2014-10-03,1591,330,1,1922,0.827783558792924,0.171696149843913
"1422",2014-10-10,1609,320,1,1930,0.833678756476684,0.16580310880829
"1423",2014-10-17,1590,328,0,1918,0.828988529718457,0.171011470281543
"1424",2014-10-24,1595,332,0,1927,0.827711468604048,0.172288531395952
"1425",2014-10-31,1582,346,1,1929,0.820114048729912,0.179367547952307
"1426",2014-11-07,1568,356,1,1925,0.814545454545455,0.184935064935065
"1427",2014-11-14,1578,350,0,1928,0.818464730290456,0.181535269709544
"1428",2014-11-21,1574,355,0,1929,0.815966822187662,0.184033177812338
"1429",2014-11-26,1572,344,1,1917,0.820031298904538,0.179447052686489
"1430",2014-12-05,1575,344,1,1920,0.8203125,0.179166666666667
"1431",2014-12-12,1546,346,1,1893,0.816693079767565,0.182778658214474
"1432",2014-12-19,1536,338,1,1875,0.8192,0.180266666666667
"1433",2014-12-26,1499,340,1,1840,0.814673913043478,0.184782608695652
"1434",2015-01-02,1482,328,1,1811,0.818332413031474,0.18111540585312
"1435",2015-01-09,1421,329,0,1750,0.812,0.188
"1436",2015-01-16,1366,310,0,1676,0.815035799522673,0.184964200477327
"1437",2015-01-23,1317,316,0,1633,0.806491120636865,0.193508879363135
"1438",2015-01-30,1223,319,1,1543,0.792611795204148,0.206740116655865
"1439",2015-02-06,1140,314,2,1456,0.782967032967033,0.215659340659341
"1440",2015-02-13,1056,300,2,1358,0.777614138438881,0.220913107511046
"1441",2015-02-20,1019,289,2,1310,0.777862595419847,0.220610687022901
"1442",2015-02-27,986,280,1,1267,0.778216258879242,0.220994475138122
"1443",2015-03-06,922,268,2,1192,0.773489932885906,0.224832214765101
"1444",2015-03-13,866,257,2,1125,0.769777777777778,0.228444444444444
"1445",2015-03-20,825,242,2,1069,0.771749298409729,0.226379794200187
"1446",2015-03-27,813,233,2,1048,0.775763358778626,0.222328244274809
"1447",2015-04-02,802,222,4,1028,0.780155642023346,0.215953307392996
"1448",2015-04-10,760,225,3,988,0.769230769230769,0.227732793522267
"1449",2015-04-17,734,217,3,954,0.769392033542977,0.227463312368973
"1450",2015-04-24,703,225,4,932,0.754291845493562,0.241416309012876
"1451",2015-05-01,679,222,4,905,0.750276243093923,0.245303867403315
"1452",2015-05-08,668,221,5,894,0.747203579418344,0.247203579418345
"1453",2015-05-15,660,223,5,888,0.743243243243243,0.251126126126126
"1454",2015-05-22,659,222,4,885,0.744632768361582,0.250847457627119
"1455",2015-05-29,646,225,4,875,0.738285714285714,0.257142857142857
"1456",2015-06-05,642,222,4,868,0.73963133640553,0.255760368663594
"1457",2015-06-12,635,221,3,859,0.739231664726426,0.257275902211874
"1458",2015-06-19,631,223,3,857,0.736289381563594,0.260210035005834
"1459",2015-06-26,628,228,3,859,0.731082654249127,0.265424912689174
"1460",2015-07-02,640,219,3,862,0.74245939675174,0.254060324825986
"1461",2015-07-10,645,217,1,863,0.74739281575898,0.251448435689455
"1462",2015-07-17,638,218,1,857,0.744457409568261,0.254375729288215
"1463",2015-07-24,659,216,1,876,0.752283105022831,0.246575342465753
"1464",2015-07-31,664,209,1,874,0.759725400457666,0.239130434782609
"1465",2015-08-07,670,213,1,884,0.757918552036199,0.240950226244344
"1466",2015-08-14,672,211,1,884,0.760180995475113,0.23868778280543
"1467",2015-08-21,674,211,0,885,0.761581920903955,0.238418079096045
"1468",2015-08-28,675,202,0,877,0.769669327251995,0.230330672748005
"1469",2015-09-04,662,202,0,864,0.766203703703704,0.233796296296296
"1470",2015-09-11,652,196,0,848,0.768867924528302,0.231132075471698
"1471",2015-09-18,644,198,0,842,0.764845605700713,0.235154394299287
"1472",2015-09-25,641,197,0,838,0.76491646778043,0.23508353221957
"1473",2015-10-02,614,195,0,809,0.758961681087763,0.241038318912237
"1474",2015-10-09,605,189,1,795,0.761006289308176,0.237735849056604
"1475",2015-10-16,595,192,0,787,0.756035578144854,0.243964421855146
"1476",2015-10-23,594,193,0,787,0.754764930114358,0.245235069885642
"1477",2015-10-30,578,197,0,775,0.745806451612903,0.254193548387097
"1478",2015-11-06,572,199,0,771,0.74189364461738,0.25810635538262
"1479",2015-11-13,574,193,0,767,0.748370273794003,0.251629726205997
"1480",2015-11-20,564,193,0,757,0.745046235138705,0.254953764861295
"1481",2015-11-25,555,189,0,744,0.745967741935484,0.254032258064516
"1482",2015-12-04,545,192,0,737,0.739484396200814,0.260515603799186
"1483",2015-12-11,524,185,0,709,0.739069111424542,0.260930888575458
"1484",2015-12-18,541,168,0,709,0.763046544428773,0.236953455571227
"1485",2015-12-23,538,162,0,700,0.768571428571429,0.231428571428571
"1486",2015-12-31,536,162,0,698,0.767908309455587,0.232091690544413
"1487",2016-01-08,516,148,0,664,0.77710843373494,0.22289156626506
"1488",2016-01-15,515,135,0,650,0.792307692307692,0.207692307692308
"1489",2016-01-22,510,127,0,637,0.800627943485086,0.199372056514914
"1490",2016-01-29,498,121,0,619,0.804523424878837,0.195476575121163
"1491",2016-02-05,467,104,0,571,0.817863397548161,0.182136602451839
"1492",2016-02-12,439,102,0,541,0.811460258780037,0.188539741219963
"1493",2016-02-19,413,101,0,514,0.803501945525292,0.196498054474708
"1494",2016-02-26,400,102,0,502,0.796812749003984,0.203187250996016
"1495",2016-03-04,392,97,0,489,0.801635991820041,0.198364008179959
"1496",2016-03-11,386,94,0,480,0.804166666666667,0.195833333333333
"1497",2016-03-18,387,89,0,476,0.813025210084034,0.186974789915966
"1498",2016-03-24,372,92,0,464,0.801724137931034,0.198275862068966
"1499",2016-04-01,362,88,0,450,0.804444444444444,0.195555555555556
"1500",2016-04-08,354,89,0,443,0.799097065462754,0.200902934537246
"1501",2016-04-15,351,89,0,440,0.797727272727273,0.202272727272727
"1502",2016-04-22,343,88,0,431,0.795823665893271,0.204176334106729
"1503",2016-04-29,332,87,1,420,0.790476190476191,0.207142857142857
"1504",2016-05-06,328,86,1,415,0.790361445783132,0.207228915662651
"1505",2016-05-13,318,87,1,406,0.783251231527094,0.214285714285714
"1506",2016-05-20,318,85,1,404,0.787128712871287,0.21039603960396
"1507",2016-05-27,316,87,1,404,0.782178217821782,0.215346534653465
"1508",2016-06-03,325,82,1,408,0.79656862745098,0.200980392156863
"1509",2016-06-10,328,85,1,414,0.792270531400966,0.205314009661836
"1510",2016-06-17,337,86,1,424,0.794811320754717,0.202830188679245
"1511",2016-06-24,330,90,1,421,0.783847980997625,0.213776722090261
"1512",2016-07-01,341,89,1,431,0.791183294663573,0.206496519721578
"1513",2016-07-08,351,88,1,440,0.797727272727273,0.2
"1514",2016-07-15,357,89,1,447,0.798657718120805,0.19910514541387
"1515",2016-07-22,371,88,3,462,0.803030303030303,0.19047619047619
"1516",2016-07-29,374,86,3,463,0.807775377969763,0.185745140388769
"1517",2016-08-05,381,81,2,464,0.821120689655172,0.174568965517241
"1518",2016-08-12,396,83,2,481,0.823284823284823,0.172557172557173
"1519",2016-08-19,406,83,2,491,0.826883910386965,0.169042769857434
"1520",2016-08-26,406,81,2,489,0.830265848670757,0.165644171779141
"1521",2016-09-02,407,88,2,497,0.818913480885312,0.177062374245473
"1522",2016-09-09,414,92,2,508,0.81496062992126,0.181102362204724
"1523",2016-09-16,416,89,1,506,0.822134387351779,0.175889328063241
"1524",2016-09-23,418,92,1,511,0.818003913894325,0.180039138943249
"1525",2016-09-30,425,96,1,522,0.814176245210728,0.183908045977012
"1526",2016-10-07,428,94,2,524,0.816793893129771,0.179389312977099
"1527",2016-10-14,432,105,2,539,0.801484230055659,0.194805194805195
"1528",2016-10-21,443,108,2,553,0.801084990958409,0.195298372513562
"1529",2016-10-28,441,114,2,557,0.791741472172352,0.204667863554758
"1530",2016-11-04,450,117,2,569,0.790861159929701,0.205623901581722
"1531",2016-11-11,452,115,1,568,0.795774647887324,0.202464788732394
"1532",2016-11-18,471,116,1,588,0.801020408163265,0.197278911564626
"1533",2016-11-23,474,118,1,593,0.799325463743676,0.198988195615514
"1534",2016-12-02,477,119,1,597,0.798994974874372,0.199329983249581
"1535",2016-12-09,498,125,1,624,0.798076923076923,0.200320512820513
"1536",2016-12-16,510,126,1,637,0.800627943485086,0.197802197802198
"1537",2016-12-23,523,129,1,653,0.800918836140888,0.197549770290965
"1538",2016-12-30,525,132,1,658,0.797872340425532,0.200607902735562
"1539",2017-01-06,529,135,1,665,0.795488721804511,0.203007518796992
"1540",2017-01-13,522,136,1,659,0.792109256449165,0.206373292867982
"1541",2017-01-20,551,142,1,694,0.793948126801153,0.204610951008646
"1542",2017-01-27,566,145,1,712,0.794943820224719,0.203651685393258
"1543",2017-02-03,583,145,1,729,0.799725651577503,0.198902606310014
"1544",2017-02-10,591,149,1,741,0.797570850202429,0.201079622132254
"1545",2017-02-17,597,153,1,751,0.794940079893475,0.203728362183755
"1546",2017-02-24,602,151,1,754,0.79840848806366,0.20026525198939
"1547",2017-03-03,609,146,1,756,0.805555555555556,0.193121693121693
"1548",2017-03-10,617,151,0,768,0.803385416666667,0.196614583333333
"1549",2017-03-17,631,157,1,789,0.799746514575412,0.198986058301648
"1550",2017-03-24,652,155,2,809,0.80593325092707,0.19159456118665
"1551",2017-03-31,662,160,2,824,0.803398058252427,0.194174757281553
"1552",2017-04-07,672,165,2,839,0.800953516090584,0.196662693682956
"1553",2017-04-13,683,162,2,847,0.806375442739079,0.191263282172373
"1554",2017-04-21,688,167,2,857,0.802800466744457,0.194865810968495
"1555",2017-04-28,697,171,2,870,0.801149425287356,0.196551724137931
"1556",2017-05-05,703,173,1,877,0.801596351197263,0.197263397947548
"1557",2017-05-12,712,172,1,885,0.804519774011299,0.194350282485876
"1558",2017-05-19,720,180,1,901,0.799112097669256,0.199778024417314
"1559",2017-05-26,722,185,1,908,0.795154185022026,0.203744493392071
"1560",2017-06-02,733,182,1,916,0.800218340611354,0.198689956331878
"1561",2017-06-09,741,185,1,927,0.799352750809062,0.199568500539374
"1562",2017-06-16,747,186,0,933,0.80064308681672,0.19935691318328
"1563",2017-06-23,758,183,0,941,0.805526036131775,0.194473963868225
"1564",2017-06-30,756,184,0,940,0.804255319148936,0.195744680851064
"1565",2017-07-07,763,189,0,952,0.801470588235294,0.198529411764706
"1566",2017-07-14,765,187,0,952,0.803571428571429,0.196428571428571
"1567",2017-07-21,764,186,0,950,0.804210526315789,0.195789473684211
"1568",2017-07-28,766,192,0,958,0.799582463465553,0.200417536534447
"1569",2017-08-04,765,189,0,954,0.80188679245283,0.19811320754717
"1570",2017-08-11,768,181,0,949,0.80927291886196,0.19072708113804
"1571",2017-08-18,763,182,1,946,0.806553911205074,0.192389006342495
"1572",2017-08-25,759,180,1,940,0.807446808510638,0.191489361702128
"1573",2017-09-01,759,183,1,943,0.804878048780488,0.19406150583245
"1574",2017-09-08,756,187,1,944,0.800847457627119,0.198093220338983
"1575",2017-09-15,749,186,1,936,0.800213675213675,0.198717948717949
"1576",2017-09-22,744,190,1,935,0.79572192513369,0.203208556149733
"1577",2017-09-29,750,189,1,940,0.797872340425532,0.201063829787234
"1578",2017-10-06,748,187,1,936,0.799145299145299,0.199786324786325
"1579",2017-10-13,743,185,0,928,0.800646551724138,0.199353448275862
"1580",2017-10-20,736,177,0,913,0.806133625410734,0.193866374589266
"1581",2017-10-27,737,172,0,909,0.810781078107811,0.189218921892189
